codcomp,dpto,secc,segm,zona,codloc,nomdpto,nomloc,V_TOT,x,V_TOT_DES,V_PAR,V_PAR_OC,V_PAR_MA,V_PAR_DES,V_COL,V_COL_OC,V_COL_DES,H_TOT,H_PAR,H_PAR_MA,H_COL,P_TOT,P_TOT_HOM,P_TOT_MUJ,P_TOT_PAR,P_HOM_PAR,P_MUJ_PAR,P_TOT_MA,P_HOM_MA,P_MUJ_MA,P_TOT_COL,P_HOM_COL,P_MUJ_COL,BARRIO85,COD_BARRIO,SECPOL_10,CCZ10,CCZ04
601001001,6,1,1,1,6220,DURAZNO,DURAZNO,21,19,2,21,19,0,2,0,0,0,19,19,0,0,52,23,29,52,23,29,0,0,0,0,0,0, ,0,1,0,0
601001002,6,1,1,2,6220,DURAZNO,DURAZNO,11,11,0,11,11,0,0,0,0,0,11,11,0,0,21,10,11,21,10,11,0,0,0,0,0,0, ,0,1,0,0
601001003,6,1,1,3,6220,DURAZNO,DURAZNO,12,8,4,12,8,0,4,0,0,0,8,8,0,0,24,11,13,24,11,13,0,0,0,0,0,0, ,0,1,0,0
601001004,6,1,1,4,6220,DURAZNO,DURAZNO,16,15,1,16,15,0,1,0,0,0,15,15,0,0,52,29,23,52,29,23,0,0,0,0,0,0, ,0,1,0,0
601001005,6,1,1,5,6220,DURAZNO,DURAZNO,52,50,2,52,50,0,2,0,0,0,50,50,0,0,131,70,61,131,70,61,0,0,0,0,0,0, ,0,1,0,0
601001006,6,1,1,6,6220,DURAZNO,DURAZNO,17,16,1,17,16,0,1,0,0,0,16,16,0,0,52,24,28,52,24,28,0,0,0,0,0,0, ,0,1,0,0
601001007,6,1,1,7,6220,DURAZNO,DURAZNO,34,33,1,34,33,0,1,0,0,0,33,33,0,0,84,42,42,84,42,42,0,0,0,0,0,0, ,0,1,0,0
601001008,6,1,1,8,6220,DURAZNO,DURAZNO,15,11,4,15,11,0,4,0,0,0,11,11,0,0,37,17,20,37,17,20,0,0,0,0,0,0, ,0,1,0,0
601001009,6,1,1,9,6220,DURAZNO,DURAZNO,22,14,8,20,14,0,6,2,0,2,14,14,0,0,32,17,15,32,17,15,0,0,0,0,0,0, ,0,1,0,0
601001010,6,1,1,10,6220,DURAZNO,DURAZNO,36,36,0,35,35,0,0,1,1,0,37,36,0,1,89,41,48,78,40,38,0,0,0,11,1,10, ,0,1,0,0
601001011,6,1,1,11,6220,DURAZNO,DURAZNO,0,0,0,0,0,0,0,0,0,0,0,0,0,0,0,0,0,0,0,0,0,0,0,0,0,0, ,0,1,0,0
601001012,6,1,1,12,6220,DURAZNO,DURAZNO,17,15,2,17,15,0,2,0,0,0,15,15,0,0,40,19,21,40,19,21,0,0,0,0,0,0, ,0,1,0,0
601001013,6,1,1,13,6220,DURAZNO,DURAZNO,21,19,2,20,18,0,2,1,1,0,20,19,0,1,56,27,29,46,23,23,0,0,0,10,4,6, ,0,1,0,0
601001014,6,1,1,14,6220,DURAZNO,DURAZNO,25,21,4,25,21,0,4,0,0,0,21,21,0,0,63,27,36,63,27,36,0,0,0,0,0,0, ,0,1,0,0
601001015,6,1,1,15,6220,DURAZNO,DURAZNO,30,25,5,30,25,0,5,0,0,0,25,25,0,0,62,33,29,62,33,29,0,0,0,0,0,0, ,0,1,0,0
601001406,6,1,1,406,6220,DURAZNO,DURAZNO,0,0,0,0,0,0,0,0,0,0,0,0,0,0,0,0,0,0,0,0,0,0,0,0,0,0, ,0,1,0,0
601001407,6,1,1,407,6220,DURAZNO,DURAZNO,0,0,0,0,0,0,0,0,0,0,0,0,0,0,0,0,0,0,0,0,0,0,0,0,0,0, ,0,1,0,0
601002003,6,1,2,3,6220,DURAZNO,DURAZNO,24,22,2,24,22,0,2,0,0,0,22,22,0,0,78,43,35,78,43,35,0,0,0,0,0,0, ,0,1,0,0
601002004,6,1,2,4,6220,DURAZNO,DURAZNO,27,26,1,27,26,0,1,0,0,0,26,26,0,0,87,46,41,87,46,41,0,0,0,0,0,0, ,0,1,0,0
601002005,6,1,2,5,6220,DURAZNO,DURAZNO,23,20,3,23,20,0,3,0,0,0,20,20,0,0,64,38,26,64,38,26,0,0,0,0,0,0, ,0,1,0,0
601002006,6,1,2,6,6220,DURAZNO,DURAZNO,19,18,1,19,18,0,1,0,0,0,18,18,0,0,58,32,26,58,32,26,0,0,0,0,0,0, ,0,1,0,0
601002007,6,1,2,7,6220,DURAZNO,DURAZNO,25,24,1,25,24,0,1,0,0,0,24,24,0,0,54,20,34,54,20,34,0,0,0,0,0,0, ,0,1,0,0
601002008,6,1,2,8,6220,DURAZNO,DURAZNO,22,20,2,22,20,0,2,0,0,0,21,21,0,0,61,32,29,61,32,29,0,0,0,0,0,0, ,0,1,0,0
601002009,6,1,2,9,6220,DURAZNO,DURAZNO,26,23,3,26,23,0,3,0,0,0,23,23,0,0,62,31,31,62,31,31,0,0,0,0,0,0, ,0,1,0,0
601002010,6,1,2,10,6220,DURAZNO,DURAZNO,26,23,3,26,23,0,3,0,0,0,23,23,0,0,60,26,34,60,26,34,0,0,0,0,0,0, ,0,1,0,0
601002011,6,1,2,11,6220,DURAZNO,DURAZNO,34,32,2,34,32,0,2,0,0,0,32,32,0,0,76,34,42,76,34,42,0,0,0,0,0,0, ,0,1,0,0
601002012,6,1,2,12,6220,DURAZNO,DURAZNO,29,28,1,29,28,0,1,0,0,0,29,29,0,0,66,35,31,66,35,31,0,0,0,0,0,0, ,0,1,0,0
601002013,6,1,2,13,6220,DURAZNO,DURAZNO,22,19,3,22,19,0,3,0,0,0,19,19,0,0,41,17,24,41,17,24,0,0,0,0,0,0, ,0,1,0,0
601002014,6,1,2,14,6220,DURAZNO,DURAZNO,23,18,5,23,18,0,5,0,0,0,19,19,0,0,47,20,27,47,20,27,0,0,0,0,0,0, ,0,1,0,0
601002015,6,1,2,15,6220,DURAZNO,DURAZNO,29,26,3,28,25,0,3,1,1,0,26,25,0,1,81,35,46,61,28,33,0,0,0,20,7,13, ,0,1,0,0
601002016,6,1,2,16,6220,DURAZNO,DURAZNO,0,0,0,0,0,0,0,0,0,0,0,0,0,0,0,0,0,0,0,0,0,0,0,0,0,0, ,0,1,0,0
601002017,6,1,2,17,6220,DURAZNO,DURAZNO,0,0,0,0,0,0,0,0,0,0,0,0,0,0,0,0,0,0,0,0,0,0,0,0,0,0, ,0,1,0,0
601002018,6,1,2,18,6220,DURAZNO,DURAZNO,5,4,1,5,4,0,1,0,0,0,4,4,0,0,13,6,7,13,6,7,0,0,0,0,0,0, ,0,1,0,0
601002700,6,1,2,700,6220,DURAZNO,DURAZNO,5,4,1,5,4,0,1,0,0,0,4,4,0,0,18,11,7,18,11,7,0,0,0,0,0,0, ,0,1,0,0
601002801,6,1,2,801,6220,DURAZNO,DURAZNO,0,0,0,0,0,0,0,0,0,0,0,0,0,0,0,0,0,0,0,0,0,0,0,0,0,0, ,0,1,0,0
601002802,6,1,2,802,6220,DURAZNO,DURAZNO,0,0,0,0,0,0,0,0,0,0,0,0,0,0,0,0,0,0,0,0,0,0,0,0,0,0, ,0,1,0,0
601003001,6,1,3,1,6220,DURAZNO,DURAZNO,17,13,4,17,13,0,4,0,0,0,13,13,0,0,37,16,21,37,16,21,0,0,0,0,0,0, ,0,1,0,0
601003002,6,1,3,2,6220,DURAZNO,DURAZNO,19,17,2,19,17,0,2,0,0,0,17,17,0,0,45,20,25,45,20,25,0,0,0,0,0,0, ,0,1,0,0
601003003,6,1,3,3,6220,DURAZNO,DURAZNO,23,21,2,23,21,0,2,0,0,0,21,21,0,0,52,22,30,52,22,30,0,0,0,0,0,0, ,0,1,0,0
601003004,6,1,3,4,6220,DURAZNO,DURAZNO,19,18,1,19,18,0,1,0,0,0,18,18,0,0,43,26,17,43,26,17,0,0,0,0,0,0, ,0,1,0,0
601003005,6,1,3,5,6220,DURAZNO,DURAZNO,22,21,1,22,21,0,1,0,0,0,21,21,0,0,53,22,31,53,22,31,0,0,0,0,0,0, ,0,1,0,0
601003006,6,1,3,6,6220,DURAZNO,DURAZNO,24,21,3,24,21,0,3,0,0,0,21,21,0,0,44,25,19,44,25,19,0,0,0,0,0,0, ,0,1,0,0
601003007,6,1,3,7,6220,DURAZNO,DURAZNO,31,25,6,31,25,0,6,0,0,0,25,25,0,0,64,27,37,64,27,37,0,0,0,0,0,0, ,0,1,0,0
601003008,6,1,3,8,6220,DURAZNO,DURAZNO,13,11,2,13,11,0,2,0,0,0,11,11,0,0,24,12,12,24,12,12,0,0,0,0,0,0, ,0,1,0,0
601003009,6,1,3,9,6220,DURAZNO,DURAZNO,16,12,4,15,12,0,3,1,0,1,12,12,0,0,36,18,18,36,18,18,0,0,0,0,0,0, ,0,1,0,0
601003010,6,1,3,10,6220,DURAZNO,DURAZNO,16,15,1,16,15,0,1,0,0,0,15,15,0,0,39,16,23,39,16,23,0,0,0,0,0,0, ,0,1,0,0
601003011,6,1,3,11,6220,DURAZNO,DURAZNO,44,37,7,43,36,0,7,1,1,0,37,36,0,1,75,34,41,73,32,41,0,0,0,2,2,0, ,0,1,0,0
601003012,6,1,3,12,6220,DURAZNO,DURAZNO,0,0,0,0,0,0,0,0,0,0,0,0,0,0,0,0,0,0,0,0,0,0,0,0,0,0, ,0,1,0,0
601003013,6,1,3,13,6220,DURAZNO,DURAZNO,28,26,2,28,26,0,2,0,0,0,26,26,0,0,64,25,39,64,25,39,0,0,0,0,0,0, ,0,1,0,0
601003014,6,1,3,14,6220,DURAZNO,DURAZNO,20,14,6,20,14,0,6,0,0,0,15,15,0,0,43,21,22,43,21,22,0,0,0,0,0,0, ,0,1,0,0
601003015,6,1,3,15,6220,DURAZNO,DURAZNO,38,28,10,38,28,0,10,0,0,0,28,28,0,0,60,26,34,60,26,34,0,0,0,0,0,0, ,0,1,0,0
601004001,6,1,4,1,6220,DURAZNO,DURAZNO,42,32,10,42,32,0,10,0,0,0,32,32,0,0,64,24,40,64,24,40,0,0,0,0,0,0, ,0,1,0,0
601004002,6,1,4,2,6220,DURAZNO,DURAZNO,19,8,11,19,8,0,11,0,0,0,8,8,0,0,16,6,10,16,6,10,0,0,0,0,0,0, ,0,1,0,0
601004003,6,1,4,3,6220,DURAZNO,DURAZNO,17,11,6,17,11,0,6,0,0,0,11,11,0,0,24,9,15,24,9,15,0,0,0,0,0,0, ,0,1,0,0
601004004,6,1,4,4,6220,DURAZNO,DURAZNO,23,18,5,23,18,0,5,0,0,0,18,18,0,0,53,24,29,53,24,29,0,0,0,0,0,0, ,0,1,0,0
601004005,6,1,4,5,6220,DURAZNO,DURAZNO,15,11,4,13,11,0,2,2,0,2,11,11,0,0,24,14,10,24,14,10,0,0,0,0,0,0, ,0,1,0,0
601004006,6,1,4,6,6220,DURAZNO,DURAZNO,14,10,4,14,10,0,4,0,0,0,10,10,0,0,27,11,16,27,11,16,0,0,0,0,0,0, ,0,1,0,0
601004007,6,1,4,7,6220,DURAZNO,DURAZNO,29,18,11,29,18,0,11,0,0,0,18,18,0,0,48,22,26,48,22,26,0,0,0,0,0,0, ,0,1,0,0
601004008,6,1,4,8,6220,DURAZNO,DURAZNO,22,19,3,20,17,0,3,2,2,0,18,17,0,1,63,21,42,42,18,24,0,0,0,21,3,18, ,0,1,0,0
601004009,6,1,4,9,6220,DURAZNO,DURAZNO,25,21,4,23,19,0,4,2,2,0,22,20,0,2,60,27,33,53,23,30,0,0,0,7,4,3, ,0,1,0,0
601004010,6,1,4,10,6220,DURAZNO,DURAZNO,22,17,5,22,17,0,5,0,0,0,19,19,0,0,40,16,24,40,16,24,0,0,0,0,0,0, ,0,1,0,0
601004011,6,1,4,11,6220,DURAZNO,DURAZNO,24,23,1,24,23,0,1,0,0,0,23,23,0,0,53,23,30,53,23,30,0,0,0,0,0,0, ,0,1,0,0
601004012,6,1,4,12,6220,DURAZNO,DURAZNO,27,27,0,27,27,0,0,0,0,0,28,28,0,0,69,34,35,69,34,35,0,0,0,0,0,0, ,0,1,0,0
601004013,6,1,4,13,6220,DURAZNO,DURAZNO,20,19,1,20,19,0,1,0,0,0,19,19,0,0,45,22,23,45,22,23,0,0,0,0,0,0, ,0,1,0,0
601004014,6,1,4,14,6220,DURAZNO,DURAZNO,34,30,4,34,30,0,4,0,0,0,30,30,0,0,68,27,41,68,27,41,0,0,0,0,0,0, ,0,1,0,0
601004015,6,1,4,15,6220,DURAZNO,DURAZNO,22,19,3,22,19,0,3,0,0,0,19,19,0,0,48,21,27,48,21,27,0,0,0,0,0,0, ,0,1,0,0
601005001,6,1,5,1,6220,DURAZNO,DURAZNO,21,21,0,21,21,0,0,0,0,0,21,21,0,0,66,26,40,66,26,40,0,0,0,0,0,0, ,0,1,0,0
601005002,6,1,5,2,6220,DURAZNO,DURAZNO,22,18,4,22,18,0,4,0,0,0,18,18,0,0,55,23,32,55,23,32,0,0,0,0,0,0, ,0,1,0,0
601005003,6,1,5,3,6220,DURAZNO,DURAZNO,66,59,7,66,59,0,7,0,0,0,59,59,0,0,148,64,84,148,64,84,0,0,0,0,0,0, ,0,1,0,0
601005004,6,1,5,4,6220,DURAZNO,DURAZNO,28,23,5,28,23,0,5,0,0,0,23,23,0,0,63,31,32,63,31,32,0,0,0,0,0,0, ,0,1,0,0
601005005,6,1,5,5,6220,DURAZNO,DURAZNO,19,15,4,19,15,0,4,0,0,0,17,17,0,0,44,20,24,44,20,24,0,0,0,0,0,0, ,0,1,0,0
601005006,6,1,5,6,6220,DURAZNO,DURAZNO,18,14,4,18,14,0,4,0,0,0,14,14,0,0,40,18,22,40,18,22,0,0,0,0,0,0, ,0,1,0,0
601005007,6,1,5,7,6220,DURAZNO,DURAZNO,22,21,1,22,21,0,1,0,0,0,21,21,0,0,57,23,34,57,23,34,0,0,0,0,0,0, ,0,1,0,0
601005008,6,1,5,8,6220,DURAZNO,DURAZNO,35,33,2,35,33,0,2,0,0,0,34,34,0,0,81,38,43,81,38,43,0,0,0,0,0,0, ,0,1,0,0
601005009,6,1,5,9,6220,DURAZNO,DURAZNO,28,25,3,28,25,0,3,0,0,0,25,25,0,0,60,25,35,60,25,35,0,0,0,0,0,0, ,0,1,0,0
601005010,6,1,5,10,6220,DURAZNO,DURAZNO,7,7,0,7,7,0,0,0,0,0,7,7,0,0,22,12,10,22,12,10,0,0,0,0,0,0, ,0,1,0,0
601005012,6,1,5,12,6220,DURAZNO,DURAZNO,9,4,5,9,4,0,5,0,0,0,4,4,0,0,13,4,9,13,4,9,0,0,0,0,0,0, ,0,1,0,0
601005013,6,1,5,13,6220,DURAZNO,DURAZNO,7,6,1,7,6,0,1,0,0,0,6,6,0,0,16,6,10,16,6,10,0,0,0,0,0,0, ,0,1,0,0
601005014,6,1,5,14,6220,DURAZNO,DURAZNO,11,8,3,11,8,0,3,0,0,0,9,9,0,0,21,8,13,21,8,13,0,0,0,0,0,0, ,0,1,0,0
601005015,6,1,5,15,6220,DURAZNO,DURAZNO,20,18,2,20,18,0,2,0,0,0,18,18,0,0,51,26,25,51,26,25,0,0,0,0,0,0, ,0,1,0,0
601005602,6,1,5,602,6220,DURAZNO,DURAZNO,6,4,2,6,4,0,2,0,0,0,4,4,0,0,13,7,6,13,7,6,0,0,0,0,0,0, ,0,1,0,0
601006001,6,1,6,1,6220,DURAZNO,DURAZNO,75,66,9,75,66,0,9,0,0,0,66,66,0,0,121,53,68,121,53,68,0,0,0,0,0,0, ,0,1,0,0
601006002,6,1,6,2,6220,DURAZNO,DURAZNO,22,16,6,21,16,0,5,1,0,1,17,17,0,0,41,19,22,41,19,22,0,0,0,0,0,0, ,0,1,0,0
601006003,6,1,6,3,6220,DURAZNO,DURAZNO,21,17,4,21,17,0,4,0,0,0,17,17,0,0,47,25,22,47,25,22,0,0,0,0,0,0, ,0,1,0,0
601006004,6,1,6,4,6220,DURAZNO,DURAZNO,44,43,1,44,43,0,1,0,0,0,43,43,0,0,98,50,48,98,50,48,0,0,0,0,0,0, ,0,1,0,0
601006005,6,1,6,5,6220,DURAZNO,DURAZNO,25,25,0,25,25,0,0,0,0,0,26,26,0,0,90,42,48,90,42,48,0,0,0,0,0,0, ,0,1,0,0
601006006,6,1,6,6,6220,DURAZNO,DURAZNO,20,20,0,20,20,0,0,0,0,0,22,22,0,0,56,31,25,56,31,25,0,0,0,0,0,0, ,0,1,0,0
601006007,6,1,6,7,6220,DURAZNO,DURAZNO,21,18,3,21,18,0,3,0,0,0,18,18,0,0,47,23,24,47,23,24,0,0,0,0,0,0, ,0,1,0,0
601006008,6,1,6,8,6220,DURAZNO,DURAZNO,31,27,4,31,27,0,4,0,0,0,27,27,0,0,56,25,31,56,25,31,0,0,0,0,0,0, ,0,1,0,0
601006009,6,1,6,9,6220,DURAZNO,DURAZNO,32,28,4,32,28,0,4,0,0,0,28,28,0,0,70,36,34,70,36,34,0,0,0,0,0,0, ,0,1,0,0
601006010,6,1,6,10,6220,DURAZNO,DURAZNO,18,13,5,18,13,0,5,0,0,0,13,13,0,0,28,11,17,28,11,17,0,0,0,0,0,0, ,0,1,0,0
601006011,6,1,6,11,6220,DURAZNO,DURAZNO,23,23,0,23,23,0,0,0,0,0,23,23,0,0,76,43,33,76,43,33,0,0,0,0,0,0, ,0,1,0,0
601006012,6,1,6,12,6220,DURAZNO,DURAZNO,30,27,3,30,27,0,3,0,0,0,27,27,0,0,60,27,33,60,27,33,0,0,0,0,0,0, ,0,1,0,0
601006013,6,1,6,13,6220,DURAZNO,DURAZNO,39,37,2,39,37,0,2,0,0,0,37,37,0,0,94,44,50,94,44,50,0,0,0,0,0,0, ,0,1,0,0
601006014,6,1,6,14,6220,DURAZNO,DURAZNO,36,29,7,36,29,0,7,0,0,0,29,29,0,0,91,50,41,91,50,41,0,0,0,0,0,0, ,0,1,0,0
601006015,6,1,6,15,6220,DURAZNO,DURAZNO,17,16,1,17,16,0,1,0,0,0,18,18,0,0,51,21,30,51,21,30,0,0,0,0,0,0, ,0,1,0,0
601006404,6,1,6,404,6220,DURAZNO,DURAZNO,0,0,0,0,0,0,0,0,0,0,0,0,0,0,0,0,0,0,0,0,0,0,0,0,0,0, ,0,1,0,0
601006405,6,1,6,405,6220,DURAZNO,DURAZNO,0,0,0,0,0,0,0,0,0,0,0,0,0,0,0,0,0,0,0,0,0,0,0,0,0,0, ,0,1,0,0
601006406,6,1,6,406,6220,DURAZNO,DURAZNO,0,0,0,0,0,0,0,0,0,0,0,0,0,0,0,0,0,0,0,0,0,0,0,0,0,0, ,0,1,0,0
601006407,6,1,6,407,6220,DURAZNO,DURAZNO,0,0,0,0,0,0,0,0,0,0,0,0,0,0,0,0,0,0,0,0,0,0,0,0,0,0, ,0,1,0,0
601007001,6,1,7,1,6220,DURAZNO,DURAZNO,29,27,2,29,27,0,2,0,0,0,27,27,0,0,76,37,39,76,37,39,0,0,0,0,0,0, ,0,1,0,0
601007002,6,1,7,2,6220,DURAZNO,DURAZNO,14,13,1,14,13,0,1,0,0,0,14,14,0,0,46,21,25,46,21,25,0,0,0,0,0,0, ,0,1,0,0
601007003,6,1,7,3,6220,DURAZNO,DURAZNO,13,11,2,13,11,0,2,0,0,0,11,11,0,0,29,17,12,29,17,12,0,0,0,0,0,0, ,0,1,0,0
601007004,6,1,7,4,6220,DURAZNO,DURAZNO,24,18,6,24,18,0,6,0,0,0,18,18,0,0,58,31,27,58,31,27,0,0,0,0,0,0, ,0,1,0,0
601007005,6,1,7,5,6220,DURAZNO,DURAZNO,30,22,8,30,22,0,8,0,0,0,22,22,0,0,80,38,42,80,38,42,0,0,0,0,0,0, ,0,1,0,0
601007006,6,1,7,6,6220,DURAZNO,DURAZNO,59,51,8,59,51,0,8,0,0,0,52,52,0,0,163,86,77,163,86,77,0,0,0,0,0,0, ,0,1,0,0
601007007,6,1,7,7,6220,DURAZNO,DURAZNO,25,20,5,25,20,0,5,0,0,0,20,20,0,0,48,21,27,48,21,27,0,0,0,0,0,0, ,0,1,0,0
601007008,6,1,7,8,6220,DURAZNO,DURAZNO,36,32,4,36,32,0,4,0,0,0,32,32,0,0,94,44,50,94,44,50,0,0,0,0,0,0, ,0,1,0,0
601007009,6,1,7,9,6220,DURAZNO,DURAZNO,15,13,2,15,13,0,2,0,0,0,13,13,0,0,22,12,10,22,12,10,0,0,0,0,0,0, ,0,1,0,0
601007010,6,1,7,10,6220,DURAZNO,DURAZNO,29,29,0,29,29,0,0,0,0,0,29,29,0,0,91,43,48,91,43,48,0,0,0,0,0,0, ,0,1,0,0
601007011,6,1,7,11,6220,DURAZNO,DURAZNO,15,12,3,15,12,0,3,0,0,0,12,12,0,0,52,28,24,52,28,24,0,0,0,0,0,0, ,0,1,0,0
601007012,6,1,7,12,6220,DURAZNO,DURAZNO,21,20,1,21,20,0,1,0,0,0,20,20,0,0,54,24,30,54,24,30,0,0,0,0,0,0, ,0,1,0,0
601007013,6,1,7,13,6220,DURAZNO,DURAZNO,2,0,2,2,0,0,2,0,0,0,0,0,0,0,0,0,0,0,0,0,0,0,0,0,0,0, ,0,1,0,0
601007014,6,1,7,14,6220,DURAZNO,DURAZNO,31,25,6,31,25,0,6,0,0,0,25,25,0,0,84,41,43,84,41,43,0,0,0,0,0,0, ,0,1,0,0
601007015,6,1,7,15,6220,DURAZNO,DURAZNO,20,18,2,20,18,0,2,0,0,0,18,18,0,0,52,24,28,52,24,28,0,0,0,0,0,0, ,0,1,0,0
601007016,6,1,7,16,6220,DURAZNO,DURAZNO,37,33,4,37,33,0,4,0,0,0,33,33,0,0,116,61,55,116,61,55,0,0,0,0,0,0, ,0,1,0,0
601008001,6,1,8,1,6220,DURAZNO,DURAZNO,21,21,0,21,21,0,0,0,0,0,23,23,0,0,62,29,33,62,29,33,0,0,0,0,0,0, ,0,1,0,0
601008003,6,1,8,3,6220,DURAZNO,DURAZNO,23,20,3,23,20,0,3,0,0,0,21,21,0,0,59,30,29,59,30,29,0,0,0,0,0,0, ,0,1,0,0
601008004,6,1,8,4,6220,DURAZNO,DURAZNO,6,4,2,5,3,0,2,1,1,0,3,3,0,0,9,5,4,9,5,4,0,0,0,0,0,0, ,0,1,0,0
601008005,6,1,8,5,6220,DURAZNO,DURAZNO,19,17,2,19,17,0,2,0,0,0,18,18,0,0,74,34,40,74,34,40,0,0,0,0,0,0, ,0,1,0,0
601008006,6,1,8,6,6220,DURAZNO,DURAZNO,6,4,2,6,4,0,2,0,0,0,5,5,0,0,27,10,17,27,10,17,0,0,0,0,0,0, ,0,1,0,0
601008007,6,1,8,7,6220,DURAZNO,DURAZNO,24,21,3,24,21,0,3,0,0,0,21,21,0,0,66,29,37,66,29,37,0,0,0,0,0,0, ,0,1,0,0
601008008,6,1,8,8,6220,DURAZNO,DURAZNO,28,27,1,28,27,0,1,0,0,0,28,28,0,0,73,34,39,73,34,39,0,0,0,0,0,0, ,0,1,0,0
601008009,6,1,8,9,6220,DURAZNO,DURAZNO,33,30,3,33,30,0,3,0,0,0,31,31,0,0,93,40,53,93,40,53,0,0,0,0,0,0, ,0,1,0,0
601008010,6,1,8,10,6220,DURAZNO,DURAZNO,22,17,5,22,17,0,5,0,0,0,17,17,0,0,55,28,27,55,28,27,0,0,0,0,0,0, ,0,1,0,0
601008011,6,1,8,11,6220,DURAZNO,DURAZNO,23,21,2,23,21,0,2,0,0,0,22,22,0,0,62,33,29,62,33,29,0,0,0,0,0,0, ,0,1,0,0
601008012,6,1,8,12,6220,DURAZNO,DURAZNO,24,19,5,24,19,0,5,0,0,0,19,19,0,0,80,36,44,80,36,44,0,0,0,0,0,0, ,0,1,0,0
601008013,6,1,8,13,6220,DURAZNO,DURAZNO,19,17,2,19,17,0,2,0,0,0,17,17,0,0,43,17,26,43,17,26,0,0,0,0,0,0, ,0,1,0,0
601008014,6,1,8,14,6220,DURAZNO,DURAZNO,1,1,0,1,1,0,0,0,0,0,1,1,0,0,2,1,1,2,1,1,0,0,0,0,0,0, ,0,1,0,0
601008102,6,1,8,102,6220,DURAZNO,DURAZNO,0,0,0,0,0,0,0,0,0,0,0,0,0,0,0,0,0,0,0,0,0,0,0,0,0,0, ,0,1,0,0
601008202,6,1,8,202,6220,DURAZNO,DURAZNO,15,10,5,15,10,0,5,0,0,0,10,10,0,0,35,18,17,35,18,17,0,0,0,0,0,0, ,0,1,0,0
601009001,6,1,9,1,6220,DURAZNO,DURAZNO,16,15,1,16,15,0,1,0,0,0,17,17,0,0,55,25,30,55,25,30,0,0,0,0,0,0, ,0,1,0,0
601009004,6,1,9,4,6220,DURAZNO,DURAZNO,12,12,0,12,12,0,0,0,0,0,12,12,0,0,33,17,16,33,17,16,0,0,0,0,0,0, ,0,1,0,0
601009005,6,1,9,5,6220,DURAZNO,DURAZNO,10,10,0,10,10,0,0,0,0,0,10,10,0,0,39,19,20,39,19,20,0,0,0,0,0,0, ,0,1,0,0
601009006,6,1,9,6,6220,DURAZNO,DURAZNO,32,27,5,32,27,1,5,0,0,0,27,27,1,0,69,35,34,69,35,34,3,1,2,0,0,0, ,0,1,0,0
601009007,6,1,9,7,6220,DURAZNO,DURAZNO,23,19,4,23,19,0,4,0,0,0,20,20,0,0,47,19,28,47,19,28,0,0,0,0,0,0, ,0,1,0,0
601009008,6,1,9,8,6220,DURAZNO,DURAZNO,30,29,1,30,29,0,1,0,0,0,29,29,0,0,98,48,50,98,48,50,0,0,0,0,0,0, ,0,1,0,0
601009009,6,1,9,9,6220,DURAZNO,DURAZNO,20,20,0,20,20,0,0,0,0,0,20,20,0,0,68,32,36,68,32,36,0,0,0,0,0,0, ,0,1,0,0
601009010,6,1,9,10,6220,DURAZNO,DURAZNO,81,76,5,81,76,0,5,0,0,0,76,76,0,0,183,81,102,183,81,102,0,0,0,0,0,0, ,0,1,0,0
601009011,6,1,9,11,6220,DURAZNO,DURAZNO,18,15,3,18,15,0,3,0,0,0,15,15,0,0,45,22,23,45,22,23,0,0,0,0,0,0, ,0,1,0,0
601009012,6,1,9,12,6220,DURAZNO,DURAZNO,27,26,1,27,26,0,1,0,0,0,26,26,0,0,63,31,32,63,31,32,0,0,0,0,0,0, ,0,1,0,0
601009013,6,1,9,13,6220,DURAZNO,DURAZNO,21,19,2,21,19,0,2,0,0,0,19,19,0,0,56,26,30,56,26,30,0,0,0,0,0,0, ,0,1,0,0
601009014,6,1,9,14,6220,DURAZNO,DURAZNO,15,13,2,15,13,0,2,0,0,0,13,13,0,0,34,18,16,34,18,16,0,0,0,0,0,0, ,0,1,0,0
601009015,6,1,9,15,6220,DURAZNO,DURAZNO,16,14,2,16,14,0,2,0,0,0,14,14,0,0,62,32,30,62,32,30,0,0,0,0,0,0, ,0,1,0,0
601009410,6,1,9,410,6220,DURAZNO,DURAZNO,0,0,0,0,0,0,0,0,0,0,0,0,0,0,0,0,0,0,0,0,0,0,0,0,0,0, ,0,1,0,0
601009411,6,1,9,411,6220,DURAZNO,DURAZNO,0,0,0,0,0,0,0,0,0,0,0,0,0,0,0,0,0,0,0,0,0,0,0,0,0,0, ,0,1,0,0
601009412,6,1,9,412,6220,DURAZNO,DURAZNO,0,0,0,0,0,0,0,0,0,0,0,0,0,0,0,0,0,0,0,0,0,0,0,0,0,0, ,0,1,0,0
601009700,6,1,9,700,6220,DURAZNO,DURAZNO,0,0,0,0,0,0,0,0,0,0,0,0,0,0,0,0,0,0,0,0,0,0,0,0,0,0, ,0,1,0,0
601010001,6,1,10,1,6220,DURAZNO,DURAZNO,22,19,3,22,19,0,3,0,0,0,19,19,0,0,53,25,28,53,25,28,0,0,0,0,0,0, ,0,1,0,0
601010002,6,1,10,2,6220,DURAZNO,DURAZNO,25,21,4,25,21,0,4,0,0,0,21,21,0,0,54,24,30,54,24,30,0,0,0,0,0,0, ,0,1,0,0
601010003,6,1,10,3,6220,DURAZNO,DURAZNO,23,19,4,23,19,0,4,0,0,0,19,19,0,0,48,20,28,48,20,28,0,0,0,0,0,0, ,0,1,0,0
601010004,6,1,10,4,6220,DURAZNO,DURAZNO,23,22,1,23,22,0,1,0,0,0,22,22,0,0,51,26,25,51,26,25,0,0,0,0,0,0, ,0,1,0,0
601010005,6,1,10,5,6220,DURAZNO,DURAZNO,21,20,1,21,20,0,1,0,0,0,20,20,0,0,58,25,33,58,25,33,0,0,0,0,0,0, ,0,1,0,0
601010006,6,1,10,6,6220,DURAZNO,DURAZNO,26,22,4,26,22,0,4,0,0,0,22,22,0,0,49,25,24,49,25,24,0,0,0,0,0,0, ,0,1,0,0
601010007,6,1,10,7,6220,DURAZNO,DURAZNO,19,18,1,19,18,0,1,0,0,0,18,18,0,0,46,21,25,46,21,25,0,0,0,0,0,0, ,0,1,0,0
601010008,6,1,10,8,6220,DURAZNO,DURAZNO,21,19,2,21,19,0,2,0,0,0,19,19,0,0,48,21,27,48,21,27,0,0,0,0,0,0, ,0,1,0,0
601010009,6,1,10,9,6220,DURAZNO,DURAZNO,33,26,7,33,26,0,7,0,0,0,26,26,0,0,72,28,44,72,28,44,0,0,0,0,0,0, ,0,1,0,0
601010010,6,1,10,10,6220,DURAZNO,DURAZNO,16,15,1,16,15,0,1,0,0,0,15,15,0,0,38,18,20,38,18,20,0,0,0,0,0,0, ,0,1,0,0
601010011,6,1,10,11,6220,DURAZNO,DURAZNO,31,26,5,30,25,0,5,1,1,0,26,25,0,1,71,34,37,63,30,33,0,0,0,8,4,4, ,0,1,0,0
601010012,6,1,10,12,6220,DURAZNO,DURAZNO,23,21,2,23,21,0,2,0,0,0,21,21,0,0,52,25,27,52,25,27,0,0,0,0,0,0, ,0,1,0,0
601010013,6,1,10,13,6220,DURAZNO,DURAZNO,19,17,2,19,17,0,2,0,0,0,17,17,0,0,37,15,22,37,15,22,0,0,0,0,0,0, ,0,1,0,0
601010014,6,1,10,14,6220,DURAZNO,DURAZNO,25,24,1,25,24,0,1,0,0,0,24,24,0,0,57,27,30,57,27,30,0,0,0,0,0,0, ,0,1,0,0
601010015,6,1,10,15,6220,DURAZNO,DURAZNO,29,24,5,29,24,0,5,0,0,0,24,24,0,0,57,28,29,57,28,29,0,0,0,0,0,0, ,0,1,0,0
601010016,6,1,10,16,6220,DURAZNO,DURAZNO,18,14,4,18,14,0,4,0,0,0,14,14,0,0,35,17,18,35,17,18,0,0,0,0,0,0, ,0,1,0,0
601011002,6,1,11,2,6220,DURAZNO,DURAZNO,17,16,1,17,16,0,1,0,0,0,16,16,0,0,34,13,21,34,13,21,0,0,0,0,0,0, ,0,1,0,0
601011003,6,1,11,3,6220,DURAZNO,DURAZNO,12,10,2,12,10,0,2,0,0,0,12,12,0,0,37,16,21,37,16,21,0,0,0,0,0,0, ,0,1,0,0
601011004,6,1,11,4,6220,DURAZNO,DURAZNO,31,30,1,31,30,0,1,0,0,0,31,31,0,0,90,41,49,90,41,49,0,0,0,0,0,0, ,0,1,0,0
601011005,6,1,11,5,6220,DURAZNO,DURAZNO,31,29,2,31,29,0,2,0,0,0,30,30,0,0,88,46,42,88,46,42,0,0,0,0,0,0, ,0,1,0,0
601011006,6,1,11,6,6220,DURAZNO,DURAZNO,37,32,5,37,32,0,5,0,0,0,32,32,0,0,97,46,51,97,46,51,0,0,0,0,0,0, ,0,1,0,0
601011007,6,1,11,7,6220,DURAZNO,DURAZNO,26,20,6,26,20,0,6,0,0,0,20,20,0,0,56,29,27,56,29,27,0,0,0,0,0,0, ,0,1,0,0
601011008,6,1,11,8,6220,DURAZNO,DURAZNO,20,19,1,20,19,0,1,0,0,0,19,19,0,0,44,18,26,44,18,26,0,0,0,0,0,0, ,0,1,0,0
601011009,6,1,11,9,6220,DURAZNO,DURAZNO,27,20,7,27,20,0,7,0,0,0,20,20,0,0,40,19,21,40,19,21,0,0,0,0,0,0, ,0,1,0,0
601011010,6,1,11,10,6220,DURAZNO,DURAZNO,32,28,4,31,27,0,4,1,1,0,28,27,0,1,68,25,43,65,25,40,0,0,0,3,0,3, ,0,1,0,0
601011011,6,1,11,11,6220,DURAZNO,DURAZNO,34,31,3,34,31,0,3,0,0,0,31,31,0,0,80,34,46,80,34,46,0,0,0,0,0,0, ,0,1,0,0
601011012,6,1,11,12,6220,DURAZNO,DURAZNO,28,26,2,28,26,0,2,0,0,0,26,26,0,0,72,36,36,72,36,36,0,0,0,0,0,0, ,0,1,0,0
601011013,6,1,11,13,6220,DURAZNO,DURAZNO,29,26,3,29,26,0,3,0,0,0,27,27,0,0,88,39,49,88,39,49,0,0,0,0,0,0, ,0,1,0,0
601011017,6,1,11,17,6220,DURAZNO,DURAZNO,23,21,2,23,21,0,2,0,0,0,22,22,0,0,58,27,31,58,27,31,0,0,0,0,0,0, ,0,1,0,0
601011018,6,1,11,18,6220,DURAZNO,DURAZNO,24,21,3,24,21,0,3,0,0,0,22,22,0,0,58,24,34,58,24,34,0,0,0,0,0,0, ,0,1,0,0
601011019,6,1,11,19,6220,DURAZNO,DURAZNO,26,20,6,26,20,0,6,0,0,0,20,20,0,0,62,27,35,62,27,35,0,0,0,0,0,0, ,0,1,0,0
601011020,6,1,11,20,6220,DURAZNO,DURAZNO,0,0,0,0,0,0,0,0,0,0,0,0,0,0,0,0,0,0,0,0,0,0,0,0,0,0, ,0,1,0,0
601011021,6,1,11,21,6220,DURAZNO,DURAZNO,14,13,1,14,13,0,1,0,0,0,13,13,0,0,37,17,20,37,17,20,0,0,0,0,0,0, ,0,1,0,0
601011022,6,1,11,22,6220,DURAZNO,DURAZNO,12,10,2,12,10,0,2,0,0,0,10,10,0,0,30,15,15,30,15,15,0,0,0,0,0,0, ,0,1,0,0
601011800,6,1,11,800,6220,DURAZNO,DURAZNO,9,8,1,9,8,0,1,0,0,0,8,8,0,0,21,9,12,21,9,12,0,0,0,0,0,0, ,0,1,0,0
601011801,6,1,11,801,6220,DURAZNO,DURAZNO,31,26,5,31,26,0,5,0,0,0,28,28,0,0,72,32,40,72,32,40,0,0,0,0,0,0, ,0,1,0,0
601011802,6,1,11,802,6220,DURAZNO,DURAZNO,0,0,0,0,0,0,0,0,0,0,0,0,0,0,0,0,0,0,0,0,0,0,0,0,0,0, ,0,1,0,0
601012001,6,1,12,1,6220,DURAZNO,DURAZNO,10,9,1,10,9,0,1,0,0,0,9,9,0,0,26,12,14,26,12,14,0,0,0,0,0,0, ,0,1,0,0
601012002,6,1,12,2,6220,DURAZNO,DURAZNO,17,15,2,17,15,0,2,0,0,0,15,15,0,0,41,21,20,41,21,20,0,0,0,0,0,0, ,0,1,0,0
601012003,6,1,12,3,6220,DURAZNO,DURAZNO,28,24,4,28,24,0,4,0,0,0,24,24,0,0,77,34,43,77,34,43,0,0,0,0,0,0, ,0,1,0,0
601012004,6,1,12,4,6220,DURAZNO,DURAZNO,35,31,4,35,31,0,4,0,0,0,34,34,0,0,91,48,43,91,48,43,0,0,0,0,0,0, ,0,1,0,0
601012005,6,1,12,5,6220,DURAZNO,DURAZNO,18,15,3,18,15,0,3,0,0,0,15,15,0,0,37,18,19,37,18,19,0,0,0,0,0,0, ,0,1,0,0
601012006,6,1,12,6,6220,DURAZNO,DURAZNO,13,12,1,13,12,0,1,0,0,0,12,12,0,0,39,20,19,39,20,19,0,0,0,0,0,0, ,0,1,0,0
601012007,6,1,12,7,6220,DURAZNO,DURAZNO,25,24,1,25,24,0,1,0,0,0,24,24,0,0,75,34,41,75,34,41,0,0,0,0,0,0, ,0,1,0,0
601012008,6,1,12,8,6220,DURAZNO,DURAZNO,30,22,8,30,22,0,8,0,0,0,22,22,0,0,55,22,33,55,22,33,0,0,0,0,0,0, ,0,1,0,0
601012011,6,1,12,11,6220,DURAZNO,DURAZNO,21,14,7,21,14,0,7,0,0,0,14,14,0,0,36,16,20,36,16,20,0,0,0,0,0,0, ,0,1,0,0
601012012,6,1,12,12,6220,DURAZNO,DURAZNO,25,19,6,25,19,0,6,0,0,0,19,19,0,0,40,15,25,40,15,25,0,0,0,0,0,0, ,0,1,0,0
601012013,6,1,12,13,6220,DURAZNO,DURAZNO,29,22,7,29,22,0,7,0,0,0,22,22,0,0,48,20,28,48,20,28,0,0,0,0,0,0, ,0,1,0,0
601012014,6,1,12,14,6220,DURAZNO,DURAZNO,14,14,0,14,14,0,0,0,0,0,14,14,0,0,35,13,22,35,13,22,0,0,0,0,0,0, ,0,1,0,0
601012015,6,1,12,15,6220,DURAZNO,DURAZNO,17,13,4,17,13,0,4,0,0,0,14,14,0,0,29,14,15,29,14,15,0,0,0,0,0,0, ,0,1,0,0
601012016,6,1,12,16,6220,DURAZNO,DURAZNO,6,4,2,6,4,0,2,0,0,0,4,4,0,0,11,5,6,11,5,6,0,0,0,0,0,0, ,0,1,0,0
601012017,6,1,12,17,6220,DURAZNO,DURAZNO,7,5,2,7,5,0,2,0,0,0,5,5,0,0,16,5,11,16,5,11,0,0,0,0,0,0, ,0,1,0,0
601012018,6,1,12,18,6220,DURAZNO,DURAZNO,26,21,5,26,21,0,5,0,0,0,22,22,0,0,69,32,37,69,32,37,0,0,0,0,0,0, ,0,1,0,0
601012019,6,1,12,19,6220,DURAZNO,DURAZNO,39,38,1,39,38,0,1,0,0,0,38,38,0,0,100,53,47,100,53,47,0,0,0,0,0,0, ,0,1,0,0
601013001,6,1,13,1,6220,DURAZNO,DURAZNO,2,1,1,2,1,0,1,0,0,0,1,1,0,0,6,4,2,6,4,2,0,0,0,0,0,0, ,0,1,0,0
601013002,6,1,13,2,6220,DURAZNO,DURAZNO,17,12,5,17,12,0,5,0,0,0,12,12,0,0,31,15,16,31,15,16,0,0,0,0,0,0, ,0,1,0,0
601013003,6,1,13,3,6220,DURAZNO,DURAZNO,10,8,2,10,8,0,2,0,0,0,9,9,0,0,19,9,10,19,9,10,0,0,0,0,0,0, ,0,1,0,0
601013004,6,1,13,4,6220,DURAZNO,DURAZNO,27,26,1,27,26,0,1,0,0,0,26,26,0,0,64,28,36,64,28,36,0,0,0,0,0,0, ,0,1,0,0
601013005,6,1,13,5,6220,DURAZNO,DURAZNO,23,19,4,23,19,0,4,0,0,0,19,19,0,0,58,26,32,58,26,32,0,0,0,0,0,0, ,0,1,0,0
601013008,6,1,13,8,6220,DURAZNO,DURAZNO,22,16,6,22,16,0,6,0,0,0,16,16,0,0,37,16,21,37,16,21,0,0,0,0,0,0, ,0,1,0,0
601013009,6,1,13,9,6220,DURAZNO,DURAZNO,23,21,2,23,21,0,2,0,0,0,21,21,0,0,51,21,30,51,21,30,0,0,0,0,0,0, ,0,1,0,0
601013400,6,1,13,400,6220,DURAZNO,DURAZNO,0,0,0,0,0,0,0,0,0,0,0,0,0,0,0,0,0,0,0,0,0,0,0,0,0,0, ,0,1,0,0
601013401,6,1,13,401,6220,DURAZNO,DURAZNO,0,0,0,0,0,0,0,0,0,0,0,0,0,0,0,0,0,0,0,0,0,0,0,0,0,0, ,0,1,0,0
601013402,6,1,13,402,6220,DURAZNO,DURAZNO,0,0,0,0,0,0,0,0,0,0,0,0,0,0,0,0,0,0,0,0,0,0,0,0,0,0, ,0,1,0,0
601013600,6,1,13,600,6220,DURAZNO,DURAZNO,8,8,0,8,8,0,0,0,0,0,8,8,0,0,25,11,14,25,11,14,0,0,0,0,0,0, ,0,1,0,0
601013601,6,1,13,601,6220,DURAZNO,DURAZNO,35,35,0,35,35,0,0,0,0,0,35,35,0,0,78,35,43,78,35,43,0,0,0,0,0,0, ,0,1,0,0
601013603,6,1,13,603,6220,DURAZNO,DURAZNO,15,13,2,15,13,0,2,0,0,0,13,13,0,0,27,12,15,27,12,15,0,0,0,0,0,0, ,0,1,0,0
601013604,6,1,13,604,6220,DURAZNO,DURAZNO,14,14,0,14,14,0,0,0,0,0,15,15,0,0,38,18,20,38,18,20,0,0,0,0,0,0, ,0,1,0,0
601013803,6,1,13,803,6220,DURAZNO,DURAZNO,0,0,0,0,0,0,0,0,0,0,0,0,0,0,0,0,0,0,0,0,0,0,0,0,0,0, ,0,1,0,0
601014001,6,1,14,1,6220,DURAZNO,DURAZNO,17,15,2,17,15,0,2,0,0,0,15,15,0,0,36,16,20,36,16,20,0,0,0,0,0,0, ,0,1,0,0
601014002,6,1,14,2,6220,DURAZNO,DURAZNO,25,23,2,25,23,0,2,0,0,0,24,24,0,0,62,26,36,62,26,36,0,0,0,0,0,0, ,0,1,0,0
601014003,6,1,14,3,6220,DURAZNO,DURAZNO,22,14,8,22,14,0,8,0,0,0,14,14,0,0,39,15,24,39,15,24,0,0,0,0,0,0, ,0,1,0,0
601014004,6,1,14,4,6220,DURAZNO,DURAZNO,34,28,6,34,28,0,6,0,0,0,28,28,0,0,77,30,47,77,30,47,0,0,0,0,0,0, ,0,1,0,0
601014005,6,1,14,5,6220,DURAZNO,DURAZNO,20,17,3,20,17,0,3,0,0,0,17,17,0,0,36,16,20,36,16,20,0,0,0,0,0,0, ,0,1,0,0
601014006,6,1,14,6,6220,DURAZNO,DURAZNO,16,13,3,16,13,0,3,0,0,0,13,13,0,0,33,18,15,33,18,15,0,0,0,0,0,0, ,0,1,0,0
601014007,6,1,14,7,6220,DURAZNO,DURAZNO,28,21,7,28,21,0,7,0,0,0,21,21,0,0,57,24,33,57,24,33,0,0,0,0,0,0, ,0,1,0,0
601014008,6,1,14,8,6220,DURAZNO,DURAZNO,27,22,5,27,22,0,5,0,0,0,23,23,0,0,58,26,32,58,26,32,0,0,0,0,0,0, ,0,1,0,0
601014009,6,1,14,9,6220,DURAZNO,DURAZNO,29,22,7,29,22,0,7,0,0,0,22,22,0,0,50,21,29,50,21,29,0,0,0,0,0,0, ,0,1,0,0
601014010,6,1,14,10,6220,DURAZNO,DURAZNO,19,17,2,19,17,0,2,0,0,0,17,17,0,0,43,19,24,43,19,24,0,0,0,0,0,0, ,0,1,0,0
601014011,6,1,14,11,6220,DURAZNO,DURAZNO,33,28,5,33,28,0,5,0,0,0,28,28,0,0,68,30,38,68,30,38,0,0,0,0,0,0, ,0,1,0,0
601014012,6,1,14,12,6220,DURAZNO,DURAZNO,29,29,0,28,28,0,0,1,1,0,29,28,0,1,69,32,37,64,29,35,0,0,0,5,3,2, ,0,1,0,0
601014013,6,1,14,13,6220,DURAZNO,DURAZNO,20,19,1,20,19,0,1,0,0,0,20,20,0,0,57,32,25,57,32,25,0,0,0,0,0,0, ,0,1,0,0
601014014,6,1,14,14,6220,DURAZNO,DURAZNO,27,24,3,27,24,0,3,0,0,0,24,24,0,0,61,25,36,61,25,36,0,0,0,0,0,0, ,0,1,0,0
601014015,6,1,14,15,6220,DURAZNO,DURAZNO,29,27,2,29,27,0,2,0,0,0,28,28,0,0,63,27,36,63,27,36,0,0,0,0,0,0, ,0,1,0,0
601014406,6,1,14,406,6220,DURAZNO,DURAZNO,0,0,0,0,0,0,0,0,0,0,0,0,0,0,0,0,0,0,0,0,0,0,0,0,0,0, ,0,1,0,0
601014407,6,1,14,407,6220,DURAZNO,DURAZNO,0,0,0,0,0,0,0,0,0,0,0,0,0,0,0,0,0,0,0,0,0,0,0,0,0,0, ,0,1,0,0
601015001,6,1,15,1,6220,DURAZNO,DURAZNO,26,26,0,26,26,0,0,0,0,0,26,26,0,0,72,36,36,72,36,36,0,0,0,0,0,0, ,0,1,0,0
601015002,6,1,15,2,6220,DURAZNO,DURAZNO,22,21,1,22,21,0,1,0,0,0,21,21,0,0,74,37,37,74,37,37,0,0,0,0,0,0, ,0,1,0,0
601015003,6,1,15,3,6220,DURAZNO,DURAZNO,22,19,3,22,19,0,3,0,0,0,21,21,0,0,63,31,32,63,31,32,0,0,0,0,0,0, ,0,1,0,0
601015004,6,1,15,4,6220,DURAZNO,DURAZNO,20,19,1,20,19,0,1,0,0,0,19,19,0,0,48,18,30,48,18,30,0,0,0,0,0,0, ,0,1,0,0
601015005,6,1,15,5,6220,DURAZNO,DURAZNO,2,2,0,0,0,0,0,2,2,0,0,0,0,0,0,0,0,0,0,0,0,0,0,0,0,0, ,0,1,0,0
601015006,6,1,15,6,6220,DURAZNO,DURAZNO,16,14,2,16,14,0,2,0,0,0,14,14,0,0,43,23,20,43,23,20,0,0,0,0,0,0, ,0,1,0,0
601015007,6,1,15,7,6220,DURAZNO,DURAZNO,10,7,3,9,6,0,3,1,1,0,6,6,0,0,22,10,12,22,10,12,0,0,0,0,0,0, ,0,1,0,0
601015008,6,1,15,8,6220,DURAZNO,DURAZNO,34,32,2,34,32,0,2,0,0,0,34,34,0,0,107,56,51,107,56,51,0,0,0,0,0,0, ,0,1,0,0
601015009,6,1,15,9,6220,DURAZNO,DURAZNO,19,17,2,19,17,0,2,0,0,0,17,17,0,0,46,22,24,46,22,24,0,0,0,0,0,0, ,0,1,0,0
601015010,6,1,15,10,6220,DURAZNO,DURAZNO,24,21,3,24,21,0,3,0,0,0,21,21,0,0,69,28,41,69,28,41,0,0,0,0,0,0, ,0,1,0,0
601015011,6,1,15,11,6220,DURAZNO,DURAZNO,30,25,5,30,25,0,5,0,0,0,28,28,0,0,76,34,42,76,34,42,0,0,0,0,0,0, ,0,1,0,0
601016001,6,1,16,1,6220,DURAZNO,DURAZNO,35,28,7,35,28,0,7,0,0,0,28,28,0,0,75,30,45,75,30,45,0,0,0,0,0,0, ,0,1,0,0
601016002,6,1,16,2,6220,DURAZNO,DURAZNO,36,26,10,36,26,0,10,0,0,0,26,26,0,0,69,35,34,69,35,34,0,0,0,0,0,0, ,0,1,0,0
601016003,6,1,16,3,6220,DURAZNO,DURAZNO,30,21,9,30,21,0,9,0,0,0,21,21,0,0,49,23,26,49,23,26,0,0,0,0,0,0, ,0,1,0,0
601016004,6,1,16,4,6220,DURAZNO,DURAZNO,20,17,3,20,17,0,3,0,0,0,20,20,0,0,63,32,31,63,32,31,0,0,0,0,0,0, ,0,1,0,0
601016005,6,1,16,5,6220,DURAZNO,DURAZNO,21,17,4,21,17,0,4,0,0,0,17,17,0,0,46,17,29,46,17,29,0,0,0,0,0,0, ,0,1,0,0
601016006,6,1,16,6,6220,DURAZNO,DURAZNO,33,22,11,33,22,0,11,0,0,0,22,22,0,0,63,33,30,63,33,30,0,0,0,0,0,0, ,0,1,0,0
601016007,6,1,16,7,6220,DURAZNO,DURAZNO,36,28,8,36,28,0,8,0,0,0,28,28,0,0,77,35,42,77,35,42,0,0,0,0,0,0, ,0,1,0,0
601016008,6,1,16,8,6220,DURAZNO,DURAZNO,1,0,1,1,0,0,1,0,0,0,0,0,0,0,0,0,0,0,0,0,0,0,0,0,0,0, ,0,1,0,0
601016010,6,1,16,10,6220,DURAZNO,DURAZNO,29,22,7,29,22,0,7,0,0,0,22,22,0,0,50,23,27,50,23,27,0,0,0,0,0,0, ,0,1,0,0
601016011,6,1,16,11,6220,DURAZNO,DURAZNO,3,2,1,3,2,0,1,0,0,0,2,2,0,0,6,3,3,6,3,3,0,0,0,0,0,0, ,0,1,0,0
601016012,6,1,16,12,6220,DURAZNO,DURAZNO,13,10,3,13,10,0,3,0,0,0,10,10,0,0,36,17,19,36,17,19,0,0,0,0,0,0, ,0,1,0,0
601016014,6,1,16,14,6220,DURAZNO,DURAZNO,0,0,0,0,0,0,0,0,0,0,0,0,0,0,0,0,0,0,0,0,0,0,0,0,0,0, ,0,1,0,0
601016015,6,1,16,15,6220,DURAZNO,DURAZNO,28,22,6,28,22,0,6,0,0,0,22,22,0,0,55,26,29,55,26,29,0,0,0,0,0,0, ,0,1,0,0
601016016,6,1,16,16,6220,DURAZNO,DURAZNO,19,15,4,19,15,0,4,0,0,0,16,16,0,0,39,18,21,39,18,21,0,0,0,0,0,0, ,0,1,0,0
601016017,6,1,16,17,6220,DURAZNO,DURAZNO,29,24,5,29,24,0,5,0,0,0,24,24,0,0,68,33,35,68,33,35,0,0,0,0,0,0, ,0,1,0,0
601016018,6,1,16,18,6220,DURAZNO,DURAZNO,27,24,3,27,24,0,3,0,0,0,27,27,0,0,77,41,36,77,41,36,0,0,0,0,0,0, ,0,1,0,0
601016019,6,1,16,19,6220,DURAZNO,DURAZNO,13,13,0,13,13,0,0,0,0,0,13,13,0,0,28,11,17,28,11,17,0,0,0,0,0,0, ,0,1,0,0
601016421,6,1,16,421,6220,DURAZNO,DURAZNO,0,0,0,0,0,0,0,0,0,0,0,0,0,0,0,0,0,0,0,0,0,0,0,0,0,0, ,0,1,0,0
601016422,6,1,16,422,6220,DURAZNO,DURAZNO,0,0,0,0,0,0,0,0,0,0,0,0,0,0,0,0,0,0,0,0,0,0,0,0,0,0, ,0,1,0,0
601016423,6,1,16,423,6220,DURAZNO,DURAZNO,0,0,0,0,0,0,0,0,0,0,0,0,0,0,0,0,0,0,0,0,0,0,0,0,0,0, ,0,1,0,0
601016424,6,1,16,424,6220,DURAZNO,DURAZNO,0,0,0,0,0,0,0,0,0,0,0,0,0,0,0,0,0,0,0,0,0,0,0,0,0,0, ,0,1,0,0
601016800,6,1,16,800,6220,DURAZNO,DURAZNO,33,26,7,33,26,0,7,0,0,0,26,26,0,0,65,26,39,65,26,39,0,0,0,0,0,0, ,0,1,0,0
601016801,6,1,16,801,6220,DURAZNO,DURAZNO,40,37,3,40,37,0,3,0,0,0,37,37,0,0,80,28,52,80,28,52,0,0,0,0,0,0, ,0,1,0,0
601016802,6,1,16,802,6220,DURAZNO,DURAZNO,32,30,2,32,30,0,2,0,0,0,30,30,0,0,62,26,36,62,26,36,0,0,0,0,0,0, ,0,1,0,0
601016803,6,1,16,803,6220,DURAZNO,DURAZNO,0,0,0,0,0,0,0,0,0,0,0,0,0,0,0,0,0,0,0,0,0,0,0,0,0,0, ,0,1,0,0
601016804,6,1,16,804,6220,DURAZNO,DURAZNO,0,0,0,0,0,0,0,0,0,0,0,0,0,0,0,0,0,0,0,0,0,0,0,0,0,0, ,0,1,0,0
601017001,6,1,17,1,6220,DURAZNO,DURAZNO,24,20,4,24,20,0,4,0,0,0,21,21,0,0,59,30,29,59,30,29,0,0,0,0,0,0, ,0,1,0,0
601017002,6,1,17,2,6220,DURAZNO,DURAZNO,17,15,2,17,15,0,2,0,0,0,15,15,0,0,45,21,24,45,21,24,0,0,0,0,0,0, ,0,1,0,0
601017004,6,1,17,4,6220,DURAZNO,DURAZNO,22,21,1,22,21,0,1,0,0,0,21,21,0,0,81,39,42,81,39,42,0,0,0,0,0,0, ,0,1,0,0
601017005,6,1,17,5,6220,DURAZNO,DURAZNO,13,13,0,13,13,0,0,0,0,0,13,13,0,0,29,12,17,29,12,17,0,0,0,0,0,0, ,0,1,0,0
601017006,6,1,17,6,6220,DURAZNO,DURAZNO,21,18,3,21,18,0,3,0,0,0,18,18,0,0,49,23,26,49,23,26,0,0,0,0,0,0, ,0,1,0,0
601017007,6,1,17,7,6220,DURAZNO,DURAZNO,24,20,4,24,20,0,4,0,0,0,20,20,0,0,68,37,31,68,37,31,0,0,0,0,0,0, ,0,1,0,0
601017008,6,1,17,8,6220,DURAZNO,DURAZNO,17,17,0,17,17,0,0,0,0,0,19,19,0,0,43,23,20,43,23,20,0,0,0,0,0,0, ,0,1,0,0
601017009,6,1,17,9,6220,DURAZNO,DURAZNO,23,21,2,23,21,0,2,0,0,0,23,23,0,0,58,33,25,58,33,25,0,0,0,0,0,0, ,0,1,0,0
601017010,6,1,17,10,6220,DURAZNO,DURAZNO,30,28,2,30,28,0,2,0,0,0,28,28,0,0,65,28,37,65,28,37,0,0,0,0,0,0, ,0,1,0,0
601017011,6,1,17,11,6220,DURAZNO,DURAZNO,23,20,3,23,20,0,3,0,0,0,20,20,0,0,66,34,32,66,34,32,0,0,0,0,0,0, ,0,1,0,0
601017012,6,1,17,12,6220,DURAZNO,DURAZNO,18,16,2,18,16,0,2,0,0,0,16,16,0,0,58,23,35,58,23,35,0,0,0,0,0,0, ,0,1,0,0
601017800,6,1,17,800,6220,DURAZNO,DURAZNO,19,17,2,19,17,0,2,0,0,0,17,17,0,0,45,23,22,45,23,22,0,0,0,0,0,0, ,0,1,0,0
601017801,6,1,17,801,6220,DURAZNO,DURAZNO,23,20,3,23,20,0,3,0,0,0,20,20,0,0,47,19,28,47,19,28,0,0,0,0,0,0, ,0,1,0,0
601018001,6,1,18,1,6220,DURAZNO,DURAZNO,20,19,1,20,19,0,1,0,0,0,19,19,0,0,58,27,31,58,27,31,0,0,0,0,0,0, ,0,1,0,0
601018002,6,1,18,2,6220,DURAZNO,DURAZNO,16,15,1,16,15,0,1,0,0,0,16,16,0,0,52,22,30,52,22,30,0,0,0,0,0,0, ,0,1,0,0
601018003,6,1,18,3,6220,DURAZNO,DURAZNO,22,19,3,22,19,0,3,0,0,0,19,19,0,0,65,31,34,65,31,34,0,0,0,0,0,0, ,0,1,0,0
601018004,6,1,18,4,6220,DURAZNO,DURAZNO,21,20,1,21,20,0,1,0,0,0,20,20,0,0,61,24,37,61,24,37,0,0,0,0,0,0, ,0,1,0,0
601018005,6,1,18,5,6220,DURAZNO,DURAZNO,2,2,0,2,2,0,0,0,0,0,2,2,0,0,2,0,2,2,0,2,0,0,0,0,0,0, ,0,1,0,0
601018008,6,1,18,8,6220,DURAZNO,DURAZNO,7,5,2,7,5,0,2,0,0,0,5,5,0,0,11,5,6,11,5,6,0,0,0,0,0,0, ,0,1,0,0
601018009,6,1,18,9,6220,DURAZNO,DURAZNO,28,23,5,28,23,0,5,0,0,0,24,24,0,0,67,29,38,67,29,38,0,0,0,0,0,0, ,0,1,0,0
601018010,6,1,18,10,6220,DURAZNO,DURAZNO,22,20,2,22,20,0,2,0,0,0,24,24,0,0,68,33,35,68,33,35,0,0,0,0,0,0, ,0,1,0,0
601018404,6,1,18,404,6220,DURAZNO,DURAZNO,0,0,0,0,0,0,0,0,0,0,0,0,0,0,0,0,0,0,0,0,0,0,0,0,0,0, ,0,1,0,0
601018600,6,1,18,600,6220,DURAZNO,DURAZNO,4,3,1,4,3,0,1,0,0,0,3,3,0,0,6,2,4,6,2,4,0,0,0,0,0,0, ,0,1,0,0
601018601,6,1,18,601,6220,DURAZNO,DURAZNO,16,16,0,16,16,0,0,0,0,0,18,18,0,0,68,33,35,68,33,35,0,0,0,0,0,0, ,0,1,0,0
601018602,6,1,18,602,6220,DURAZNO,DURAZNO,28,26,2,28,26,0,2,0,0,0,28,28,0,0,90,48,42,90,48,42,0,0,0,0,0,0, ,0,1,0,0
601018603,6,1,18,603,6220,DURAZNO,DURAZNO,42,38,4,42,38,0,4,0,0,0,40,40,0,0,114,54,60,114,54,60,0,0,0,0,0,0, ,0,1,0,0
601018920,6,1,18,920,6220,DURAZNO,DURAZNO,0,0,0,0,0,0,0,0,0,0,0,0,0,0,0,0,0,0,0,0,0,0,0,0,0,0, ,0,1,0,0
601019001,6,1,19,1,6220,DURAZNO,DURAZNO,0,0,0,0,0,0,0,0,0,0,0,0,0,0,0,0,0,0,0,0,0,0,0,0,0,0, ,0,1,0,0
601019002,6,1,19,2,6220,DURAZNO,DURAZNO,5,5,0,5,5,0,0,0,0,0,5,5,0,0,21,11,10,21,11,10,0,0,0,0,0,0, ,0,1,0,0
601019003,6,1,19,3,6220,DURAZNO,DURAZNO,11,7,4,11,7,0,4,0,0,0,7,7,0,0,29,13,16,29,13,16,0,0,0,0,0,0, ,0,1,0,0
601019004,6,1,19,4,6220,DURAZNO,DURAZNO,20,17,3,20,17,0,3,0,0,0,18,18,0,0,47,22,25,47,22,25,0,0,0,0,0,0, ,0,1,0,0
601019005,6,1,19,5,6220,DURAZNO,DURAZNO,20,18,2,20,18,0,2,0,0,0,21,21,0,0,54,29,25,54,29,25,0,0,0,0,0,0, ,0,1,0,0
601019006,6,1,19,6,6220,DURAZNO,DURAZNO,28,26,2,28,26,0,2,0,0,0,27,27,0,0,68,33,35,68,33,35,0,0,0,0,0,0, ,0,1,0,0
601019007,6,1,19,7,6220,DURAZNO,DURAZNO,16,16,0,16,16,0,0,0,0,0,16,16,0,0,48,26,22,48,26,22,0,0,0,0,0,0, ,0,1,0,0
601019008,6,1,19,8,6220,DURAZNO,DURAZNO,56,53,3,56,53,0,3,0,0,0,54,54,0,0,146,61,85,146,61,85,0,0,0,0,0,0, ,0,1,0,0
601019009,6,1,19,9,6220,DURAZNO,DURAZNO,27,26,1,27,26,0,1,0,0,0,27,27,0,0,88,43,45,88,43,45,0,0,0,0,0,0, ,0,1,0,0
601019010,6,1,19,10,6220,DURAZNO,DURAZNO,21,19,2,21,19,0,2,0,0,0,19,19,0,0,74,39,35,74,39,35,0,0,0,0,0,0, ,0,1,0,0
601019012,6,1,19,12,6220,DURAZNO,DURAZNO,9,8,1,9,8,0,1,0,0,0,8,8,0,0,18,11,7,18,11,7,0,0,0,0,0,0, ,0,1,0,0
601019013,6,1,19,13,6220,DURAZNO,DURAZNO,13,11,2,13,11,0,2,0,0,0,12,12,0,0,36,18,18,36,18,18,0,0,0,0,0,0, ,0,1,0,0
601019015,6,1,19,15,6220,DURAZNO,DURAZNO,0,0,0,0,0,0,0,0,0,0,0,0,0,0,0,0,0,0,0,0,0,0,0,0,0,0, ,0,1,0,0
601019404,6,1,19,404,6220,DURAZNO,DURAZNO,0,0,0,0,0,0,0,0,0,0,0,0,0,0,0,0,0,0,0,0,0,0,0,0,0,0, ,0,1,0,0
601019405,6,1,19,405,6220,DURAZNO,DURAZNO,0,0,0,0,0,0,0,0,0,0,0,0,0,0,0,0,0,0,0,0,0,0,0,0,0,0, ,0,1,0,0
601019600,6,1,19,600,6220,DURAZNO,DURAZNO,0,0,0,0,0,0,0,0,0,0,0,0,0,0,0,0,0,0,0,0,0,0,0,0,0,0, ,0,1,0,0
601019601,6,1,19,601,6220,DURAZNO,DURAZNO,4,3,1,4,3,0,1,0,0,0,3,3,0,0,4,3,1,4,3,1,0,0,0,0,0,0, ,0,1,0,0
601020001,6,1,20,1,6220,DURAZNO,DURAZNO,0,0,0,0,0,0,0,0,0,0,0,0,0,0,0,0,0,0,0,0,0,0,0,0,0,0, ,0,1,0,0
601020002,6,1,20,2,6220,DURAZNO,DURAZNO,5,3,2,5,3,0,2,0,0,0,3,3,0,0,9,4,5,9,4,5,0,0,0,0,0,0, ,0,1,0,0
601020005,6,1,20,5,6220,DURAZNO,DURAZNO,25,18,7,25,18,0,7,0,0,0,18,18,0,0,79,35,44,79,35,44,0,0,0,0,0,0, ,0,1,0,0
601020006,6,1,20,6,6220,DURAZNO,DURAZNO,26,25,1,26,25,0,1,0,0,0,25,25,0,0,62,27,35,62,27,35,0,0,0,0,0,0, ,0,1,0,0
601020007,6,1,20,7,6220,DURAZNO,DURAZNO,29,21,8,29,21,0,8,0,0,0,21,21,0,0,67,36,31,67,36,31,0,0,0,0,0,0, ,0,1,0,0
601020008,6,1,20,8,6220,DURAZNO,DURAZNO,11,8,3,11,8,0,3,0,0,0,8,8,0,0,26,11,15,26,11,15,0,0,0,0,0,0, ,0,1,0,0
601020009,6,1,20,9,6220,DURAZNO,DURAZNO,40,36,4,40,36,0,4,0,0,0,37,37,0,0,96,47,49,96,47,49,0,0,0,0,0,0, ,0,1,0,0
601020010,6,1,20,10,6220,DURAZNO,DURAZNO,23,21,2,23,21,0,2,0,0,0,22,22,0,0,76,34,42,76,34,42,0,0,0,0,0,0, ,0,1,0,0
601020011,6,1,20,11,6220,DURAZNO,DURAZNO,1,1,0,1,1,0,0,0,0,0,1,1,0,0,4,2,2,4,2,2,0,0,0,0,0,0, ,0,1,0,0
601020012,6,1,20,12,6220,DURAZNO,DURAZNO,27,25,2,27,25,0,2,0,0,0,25,25,0,0,59,25,34,59,25,34,0,0,0,0,0,0, ,0,1,0,0
601020015,6,1,20,15,6220,DURAZNO,DURAZNO,44,33,11,44,33,0,11,0,0,0,33,33,0,0,92,46,46,92,46,46,0,0,0,0,0,0, ,0,1,0,0
601020016,6,1,20,16,6220,DURAZNO,DURAZNO,28,21,7,28,21,0,7,0,0,0,21,21,0,0,60,27,33,60,27,33,0,0,0,0,0,0, ,0,1,0,0
601020017,6,1,20,17,6220,DURAZNO,DURAZNO,31,25,6,31,25,0,6,0,0,0,25,25,0,0,62,25,37,62,25,37,0,0,0,0,0,0, ,0,1,0,0
601020018,6,1,20,18,6220,DURAZNO,DURAZNO,26,24,2,26,24,0,2,0,0,0,24,24,0,0,63,29,34,63,29,34,0,0,0,0,0,0, ,0,1,0,0
601020019,6,1,20,19,6220,DURAZNO,DURAZNO,20,19,1,20,19,0,1,0,0,0,19,19,0,0,47,18,29,47,18,29,0,0,0,0,0,0, ,0,1,0,0
601020104,6,1,20,104,6220,DURAZNO,DURAZNO,21,19,2,21,19,0,2,0,0,0,19,19,0,0,98,57,41,98,57,41,0,0,0,0,0,0, ,0,1,0,0
601020204,6,1,20,204,6220,DURAZNO,DURAZNO,0,0,0,0,0,0,0,0,0,0,0,0,0,0,0,0,0,0,0,0,0,0,0,0,0,0, ,0,1,0,0
601020400,6,1,20,400,6220,DURAZNO,DURAZNO,0,0,0,0,0,0,0,0,0,0,0,0,0,0,0,0,0,0,0,0,0,0,0,0,0,0, ,0,1,0,0
601020500,6,1,20,500,6220,DURAZNO,DURAZNO,0,0,0,0,0,0,0,0,0,0,0,0,0,0,0,0,0,0,0,0,0,0,0,0,0,0, ,0,1,0,0
601020501,6,1,20,501,6220,DURAZNO,DURAZNO,0,0,0,0,0,0,0,0,0,0,0,0,0,0,0,0,0,0,0,0,0,0,0,0,0,0, ,0,1,0,0
601020800,6,1,20,800,6220,DURAZNO,DURAZNO,6,5,1,6,5,0,1,0,0,0,5,5,0,0,20,7,13,20,7,13,0,0,0,0,0,0, ,0,1,0,0
601020801,6,1,20,801,6220,DURAZNO,DURAZNO,24,24,0,24,24,0,0,0,0,0,24,24,0,0,56,26,30,56,26,30,0,0,0,0,0,0, ,0,1,0,0
601020802,6,1,20,802,6220,DURAZNO,DURAZNO,13,12,1,13,12,0,1,0,0,0,12,12,0,0,24,10,14,24,10,14,0,0,0,0,0,0, ,0,1,0,0
601020803,6,1,20,803,6220,DURAZNO,DURAZNO,18,16,2,18,16,0,2,0,0,0,16,16,0,0,36,15,21,36,15,21,0,0,0,0,0,0, ,0,1,0,0
601021003,6,1,21,3,6220,DURAZNO,DURAZNO,0,0,0,0,0,0,0,0,0,0,0,0,0,0,0,0,0,0,0,0,0,0,0,0,0,0, ,0,1,0,0
601021004,6,1,21,4,6220,DURAZNO,DURAZNO,0,0,0,0,0,0,0,0,0,0,0,0,0,0,0,0,0,0,0,0,0,0,0,0,0,0, ,0,1,0,0
601021005,6,1,21,5,6220,DURAZNO,DURAZNO,22,19,3,22,19,0,3,0,0,0,19,19,0,0,53,29,24,53,29,24,0,0,0,0,0,0, ,0,1,0,0
601021006,6,1,21,6,6220,DURAZNO,DURAZNO,0,0,0,0,0,0,0,0,0,0,0,0,0,0,0,0,0,0,0,0,0,0,0,0,0,0, ,0,1,0,0
601021007,6,1,21,7,6220,DURAZNO,DURAZNO,9,6,3,9,6,0,3,0,0,0,6,6,0,0,23,12,11,23,12,11,0,0,0,0,0,0, ,0,1,0,0
601021008,6,1,21,8,6220,DURAZNO,DURAZNO,26,18,8,26,18,0,8,0,0,0,18,18,0,0,74,39,35,74,39,35,0,0,0,0,0,0, ,0,1,0,0
601021009,6,1,21,9,6220,DURAZNO,DURAZNO,31,28,3,31,28,0,3,0,0,0,28,28,0,0,94,46,48,94,46,48,0,0,0,0,0,0, ,0,1,0,0
601021010,6,1,21,10,6220,DURAZNO,DURAZNO,22,19,3,22,19,0,3,0,0,0,19,19,0,0,71,31,40,71,31,40,0,0,0,0,0,0, ,0,1,0,0
601021011,6,1,21,11,6220,DURAZNO,DURAZNO,25,19,6,25,19,0,6,0,0,0,21,21,0,0,52,26,26,52,26,26,0,0,0,0,0,0, ,0,1,0,0
601021012,6,1,21,12,6220,DURAZNO,DURAZNO,36,33,3,36,33,0,3,0,0,0,33,33,0,0,109,55,54,109,55,54,0,0,0,0,0,0, ,0,1,0,0
601021013,6,1,21,13,6220,DURAZNO,DURAZNO,38,32,6,38,32,0,6,0,0,0,33,33,0,0,114,55,59,114,55,59,0,0,0,0,0,0, ,0,1,0,0
601021014,6,1,21,14,6220,DURAZNO,DURAZNO,24,22,2,24,22,0,2,0,0,0,22,22,0,0,64,36,28,64,36,28,0,0,0,0,0,0, ,0,1,0,0
601021015,6,1,21,15,6220,DURAZNO,DURAZNO,26,23,3,26,23,0,3,0,0,0,25,25,0,0,66,34,32,66,34,32,0,0,0,0,0,0, ,0,1,0,0
601021016,6,1,21,16,6220,DURAZNO,DURAZNO,27,21,6,27,21,0,6,0,0,0,21,21,0,0,59,28,31,59,28,31,0,0,0,0,0,0, ,0,1,0,0
601021700,6,1,21,700,6220,DURAZNO,DURAZNO,0,0,0,0,0,0,0,0,0,0,0,0,0,0,0,0,0,0,0,0,0,0,0,0,0,0, ,0,1,0,0
601022002,6,1,22,2,6220,DURAZNO,DURAZNO,1,1,0,1,1,0,0,0,0,0,1,1,0,0,2,2,0,2,2,0,0,0,0,0,0,0, ,0,1,0,0
601022003,6,1,22,3,6220,DURAZNO,DURAZNO,15,9,6,15,9,0,6,0,0,0,9,9,0,0,28,18,10,28,18,10,0,0,0,0,0,0, ,0,1,0,0
601022004,6,1,22,4,6220,DURAZNO,DURAZNO,11,8,3,11,8,0,3,0,0,0,8,8,0,0,29,19,10,29,19,10,0,0,0,0,0,0, ,0,1,0,0
601022005,6,1,22,5,6220,DURAZNO,DURAZNO,2,1,1,2,1,0,1,0,0,0,1,1,0,0,1,1,0,1,1,0,0,0,0,0,0,0, ,0,1,0,0
601022006,6,1,22,6,6220,DURAZNO,DURAZNO,8,8,0,8,8,0,0,0,0,0,8,8,0,0,23,12,11,23,12,11,0,0,0,0,0,0, ,0,1,0,0
601022007,6,1,22,7,6220,DURAZNO,DURAZNO,9,8,1,9,8,0,1,0,0,0,8,8,0,0,22,11,11,22,11,11,0,0,0,0,0,0, ,0,1,0,0
601022008,6,1,22,8,6220,DURAZNO,DURAZNO,22,17,5,22,17,0,5,0,0,0,17,17,0,0,56,31,25,56,31,25,0,0,0,0,0,0, ,0,1,0,0
601022009,6,1,22,9,6220,DURAZNO,DURAZNO,33,33,0,33,33,0,0,0,0,0,33,33,0,0,100,44,56,100,44,56,0,0,0,0,0,0, ,0,1,0,0
601022010,6,1,22,10,6220,DURAZNO,DURAZNO,41,38,3,41,38,0,3,0,0,0,43,43,0,0,157,79,78,157,79,78,0,0,0,0,0,0, ,0,1,0,0
601022013,6,1,22,13,6220,DURAZNO,DURAZNO,28,26,2,28,26,0,2,0,0,0,27,27,0,0,117,59,58,117,59,58,0,0,0,0,0,0, ,0,1,0,0
601022014,6,1,22,14,6220,DURAZNO,DURAZNO,38,34,4,38,34,0,4,0,0,0,34,34,0,0,127,66,61,127,66,61,0,0,0,0,0,0, ,0,1,0,0
601022015,6,1,22,15,6220,DURAZNO,DURAZNO,31,25,6,31,25,0,6,0,0,0,25,25,0,0,80,45,35,80,45,35,0,0,0,0,0,0, ,0,1,0,0
601022016,6,1,22,16,6220,DURAZNO,DURAZNO,26,25,1,26,25,0,1,0,0,0,29,29,0,0,89,42,47,89,42,47,0,0,0,0,0,0, ,0,1,0,0
601022017,6,1,22,17,6220,DURAZNO,DURAZNO,33,32,1,33,32,0,1,0,0,0,32,32,0,0,101,49,52,101,49,52,0,0,0,0,0,0, ,0,1,0,0
601022018,6,1,22,18,6220,DURAZNO,DURAZNO,11,9,2,11,9,0,2,0,0,0,9,9,0,0,27,13,14,27,13,14,0,0,0,0,0,0, ,0,1,0,0
601022019,6,1,22,19,6220,DURAZNO,DURAZNO,0,0,0,0,0,0,0,0,0,0,0,0,0,0,0,0,0,0,0,0,0,0,0,0,0,0, ,0,1,0,0
601022600,6,1,22,600,6220,DURAZNO,DURAZNO,1,1,0,1,1,0,0,0,0,0,1,1,0,0,9,4,5,9,4,5,0,0,0,0,0,0, ,0,1,0,0
601022601,6,1,22,601,6220,DURAZNO,DURAZNO,0,0,0,0,0,0,0,0,0,0,0,0,0,0,0,0,0,0,0,0,0,0,0,0,0,0, ,0,1,0,0
601022602,6,1,22,602,6220,DURAZNO,DURAZNO,9,8,1,9,8,0,1,0,0,0,8,8,0,0,30,17,13,30,17,13,0,0,0,0,0,0, ,0,1,0,0
601023001,6,1,23,1,6220,DURAZNO,DURAZNO,28,24,4,28,24,0,4,0,0,0,24,24,0,0,91,50,41,91,50,41,0,0,0,0,0,0, ,0,1,0,0
601023002,6,1,23,2,6220,DURAZNO,DURAZNO,36,26,10,36,26,0,10,0,0,0,26,26,0,0,89,43,46,89,43,46,0,0,0,0,0,0, ,0,1,0,0
601023003,6,1,23,3,6220,DURAZNO,DURAZNO,19,19,0,19,19,0,0,0,0,0,19,19,0,0,64,29,35,64,29,35,0,0,0,0,0,0, ,0,1,0,0
601023004,6,1,23,4,6220,DURAZNO,DURAZNO,32,29,3,32,29,0,3,0,0,0,30,30,0,0,100,51,49,100,51,49,0,0,0,0,0,0, ,0,1,0,0
601023005,6,1,23,5,6220,DURAZNO,DURAZNO,16,13,3,15,12,0,3,1,1,0,13,12,0,1,32,12,20,28,12,16,0,0,0,4,0,4, ,0,1,0,0
601023006,6,1,23,6,6220,DURAZNO,DURAZNO,25,23,2,25,23,0,2,0,0,0,23,23,0,0,70,38,32,70,38,32,0,0,0,0,0,0, ,0,1,0,0
601023007,6,1,23,7,6220,DURAZNO,DURAZNO,26,26,0,26,26,0,0,0,0,0,26,26,0,0,63,29,34,63,29,34,0,0,0,0,0,0, ,0,1,0,0
601023008,6,1,23,8,6220,DURAZNO,DURAZNO,22,19,3,22,19,1,3,0,0,0,19,19,1,0,56,26,30,56,26,30,2,1,1,0,0,0, ,0,1,0,0
601023009,6,1,23,9,6220,DURAZNO,DURAZNO,15,13,2,15,13,0,2,0,0,0,13,13,0,0,43,20,23,43,20,23,0,0,0,0,0,0, ,0,1,0,0
601023011,6,1,23,11,6220,DURAZNO,DURAZNO,61,61,0,61,61,0,0,0,0,0,62,62,0,0,179,85,94,179,85,94,0,0,0,0,0,0, ,0,1,0,0
601023012,6,1,23,12,6220,DURAZNO,DURAZNO,30,28,2,30,28,0,2,0,0,0,28,28,0,0,90,38,52,90,38,52,0,0,0,0,0,0, ,0,1,0,0
601023013,6,1,23,13,6220,DURAZNO,DURAZNO,27,26,1,27,26,0,1,0,0,0,26,26,0,0,70,34,36,70,34,36,0,0,0,0,0,0, ,0,1,0,0
601023014,6,1,23,14,6220,DURAZNO,DURAZNO,26,25,1,25,24,0,1,1,1,0,25,24,0,1,83,34,49,61,27,34,0,0,0,22,7,15, ,0,1,0,0
601023015,6,1,23,15,6220,DURAZNO,DURAZNO,41,31,10,41,31,0,10,0,0,0,31,31,0,0,75,37,38,75,37,38,0,0,0,0,0,0, ,0,1,0,0
601023016,6,1,23,16,6220,DURAZNO,DURAZNO,27,27,0,27,27,0,0,0,0,0,27,27,0,0,109,61,48,109,61,48,0,0,0,0,0,0, ,0,1,0,0
601023017,6,1,23,17,6220,DURAZNO,DURAZNO,14,13,1,14,13,0,1,0,0,0,13,13,0,0,44,20,24,44,20,24,0,0,0,0,0,0, ,0,1,0,0
601024001,6,1,24,1,6220,DURAZNO,DURAZNO,0,0,0,0,0,0,0,0,0,0,0,0,0,0,0,0,0,0,0,0,0,0,0,0,0,0, ,0,2,0,0
601024002,6,1,24,2,6220,DURAZNO,DURAZNO,0,0,0,0,0,0,0,0,0,0,0,0,0,0,0,0,0,0,0,0,0,0,0,0,0,0, ,0,2,0,0
601024004,6,1,24,4,6220,DURAZNO,DURAZNO,20,19,1,20,19,0,1,0,0,0,19,19,0,0,54,28,26,54,28,26,0,0,0,0,0,0, ,0,1,0,0
601024800,6,1,24,800,6220,DURAZNO,DURAZNO,21,20,1,21,20,0,1,0,0,0,22,22,0,0,92,44,48,92,44,48,0,0,0,0,0,0, ,0,1,0,0
601024801,6,1,24,801,6220,DURAZNO,DURAZNO,41,38,3,41,38,0,3,0,0,0,38,38,0,0,154,82,72,154,82,72,0,0,0,0,0,0, ,0,1,0,0
601024802,6,1,24,802,6220,DURAZNO,DURAZNO,70,70,0,70,70,0,0,0,0,0,71,71,0,0,291,151,140,291,151,140,0,0,0,0,0,0, ,0,1,0,0
601024803,6,1,24,803,6220,DURAZNO,DURAZNO,16,14,2,16,14,0,2,0,0,0,14,14,0,0,48,26,22,48,26,22,0,0,0,0,0,0, ,0,2,0,0
601024804,6,1,24,804,6220,DURAZNO,DURAZNO,4,4,0,4,4,0,0,0,0,0,4,4,0,0,17,7,10,17,7,10,0,0,0,0,0,0, ,0,1,0,0
601025002,6,1,25,2,6220,DURAZNO,DURAZNO,24,24,0,24,24,1,0,0,0,0,25,25,1,0,87,39,48,87,39,48,1,0,1,0,0,0, ,0,1,0,0
601025003,6,1,25,3,6220,DURAZNO,DURAZNO,0,0,0,0,0,0,0,0,0,0,0,0,0,0,0,0,0,0,0,0,0,0,0,0,0,0, ,0,1,0,0
601025004,6,1,25,4,6220,DURAZNO,DURAZNO,12,11,1,12,11,0,1,0,0,0,11,11,0,0,33,17,16,33,17,16,0,0,0,0,0,0, ,0,1,0,0
601025006,6,1,25,6,6220,DURAZNO,DURAZNO,25,24,1,25,24,0,1,0,0,0,25,25,0,0,85,40,45,85,40,45,0,0,0,0,0,0, ,0,1,0,0
601025007,6,1,25,7,6220,DURAZNO,DURAZNO,11,11,0,11,11,0,0,0,0,0,11,11,0,0,47,27,20,47,27,20,0,0,0,0,0,0, ,0,1,0,0
601025009,6,1,25,9,6220,DURAZNO,DURAZNO,27,26,1,27,26,0,1,0,0,0,27,27,0,0,70,36,34,70,36,34,0,0,0,0,0,0, ,0,1,0,0
601025010,6,1,25,10,6220,DURAZNO,DURAZNO,38,35,3,38,35,0,3,0,0,0,35,35,0,0,106,51,55,106,51,55,0,0,0,0,0,0, ,0,1,0,0
601025011,6,1,25,11,6220,DURAZNO,DURAZNO,29,28,1,29,28,0,1,0,0,0,29,29,0,0,89,49,40,89,49,40,0,0,0,0,0,0, ,0,1,0,0
601025012,6,1,25,12,6220,DURAZNO,DURAZNO,32,31,1,32,31,0,1,0,0,0,32,32,0,0,126,62,64,126,62,64,0,0,0,0,0,0, ,0,1,0,0
601025013,6,1,25,13,6220,DURAZNO,DURAZNO,22,17,5,22,17,0,5,0,0,0,17,17,0,0,52,24,28,52,24,28,0,0,0,0,0,0, ,0,1,0,0
601025014,6,1,25,14,6220,DURAZNO,DURAZNO,21,20,1,21,20,0,1,0,0,0,24,24,0,0,68,31,37,68,31,37,0,0,0,0,0,0, ,0,1,0,0
601025015,6,1,25,15,6220,DURAZNO,DURAZNO,4,4,0,4,4,0,0,0,0,0,4,4,0,0,15,9,6,15,9,6,0,0,0,0,0,0, ,0,1,0,0
601025400,6,1,25,400,6220,DURAZNO,DURAZNO,0,0,0,0,0,0,0,0,0,0,0,0,0,0,0,0,0,0,0,0,0,0,0,0,0,0, ,0,1,0,0
601025401,6,1,25,401,6220,DURAZNO,DURAZNO,0,0,0,0,0,0,0,0,0,0,0,0,0,0,0,0,0,0,0,0,0,0,0,0,0,0, ,0,1,0,0
601025402,6,1,25,402,6220,DURAZNO,DURAZNO,0,0,0,0,0,0,0,0,0,0,0,0,0,0,0,0,0,0,0,0,0,0,0,0,0,0, ,0,1,0,0
601025403,6,1,25,403,6220,DURAZNO,DURAZNO,0,0,0,0,0,0,0,0,0,0,0,0,0,0,0,0,0,0,0,0,0,0,0,0,0,0, ,0,1,0,0
601025600,6,1,25,600,6220,DURAZNO,DURAZNO,49,49,0,49,49,0,0,0,0,0,50,50,0,0,185,98,87,185,98,87,0,0,0,0,0,0, ,0,1,0,0
601025800,6,1,25,800,6220,DURAZNO,DURAZNO,25,23,2,25,23,0,2,0,0,0,26,26,0,0,96,45,51,96,45,51,0,0,0,0,0,0, ,0,1,0,0
601025801,6,1,25,801,6220,DURAZNO,DURAZNO,8,8,0,8,8,0,0,0,0,0,8,8,0,0,19,11,8,19,11,8,0,0,0,0,0,0, ,0,1,0,0
601025802,6,1,25,802,6220,DURAZNO,DURAZNO,5,5,0,5,5,0,0,0,0,0,5,5,0,0,18,9,9,18,9,9,0,0,0,0,0,0, ,0,1,0,0
601025803,6,1,25,803,6220,DURAZNO,DURAZNO,9,9,0,9,9,0,0,0,0,0,9,9,0,0,26,17,9,26,17,9,0,0,0,0,0,0, ,0,1,0,0
601025804,6,1,25,804,6220,DURAZNO,DURAZNO,9,8,1,9,8,0,1,0,0,0,8,8,0,0,26,11,15,26,11,15,0,0,0,0,0,0, ,0,1,0,0
601027001,6,1,27,1,6220,DURAZNO,DURAZNO,95,84,11,95,84,0,11,0,0,0,91,91,0,0,344,175,169,344,175,169,0,0,0,0,0,0, ,0,1,0,0
601027006,6,1,27,6,6220,DURAZNO,DURAZNO,7,7,0,7,7,0,0,0,0,0,7,7,0,0,24,14,10,24,14,10,0,0,0,0,0,0, ,0,1,0,0
601027007,6,1,27,7,6220,DURAZNO,DURAZNO,27,26,1,27,26,0,1,0,0,0,26,26,0,0,75,35,40,75,35,40,0,0,0,0,0,0, ,0,1,0,0
601027008,6,1,27,8,6220,DURAZNO,DURAZNO,17,14,3,17,14,0,3,0,0,0,14,14,0,0,56,20,36,56,20,36,0,0,0,0,0,0, ,0,1,0,0
601027009,6,1,27,9,6220,DURAZNO,DURAZNO,18,15,3,18,15,0,3,0,0,0,15,15,0,0,39,14,25,39,14,25,0,0,0,0,0,0, ,0,1,0,0
601027010,6,1,27,10,6220,DURAZNO,DURAZNO,23,23,0,23,23,0,0,0,0,0,23,23,0,0,78,37,41,78,37,41,0,0,0,0,0,0, ,0,1,0,0
601027011,6,1,27,11,6220,DURAZNO,DURAZNO,5,4,1,5,4,0,1,0,0,0,4,4,0,0,12,5,7,12,5,7,0,0,0,0,0,0, ,0,1,0,0
601027012,6,1,27,12,6220,DURAZNO,DURAZNO,4,4,0,4,4,0,0,0,0,0,5,5,0,0,18,8,10,18,8,10,0,0,0,0,0,0, ,0,1,0,0
601027013,6,1,27,13,6220,DURAZNO,DURAZNO,12,11,1,12,11,0,1,0,0,0,11,11,0,0,46,26,20,46,26,20,0,0,0,0,0,0, ,0,1,0,0
601027014,6,1,27,14,6220,DURAZNO,DURAZNO,11,11,0,11,11,0,0,0,0,0,12,12,0,0,43,23,20,43,23,20,0,0,0,0,0,0, ,0,1,0,0
601027015,6,1,27,15,6220,DURAZNO,DURAZNO,22,21,1,22,21,0,1,0,0,0,21,21,0,0,63,32,31,63,32,31,0,0,0,0,0,0, ,0,1,0,0
601027016,6,1,27,16,6220,DURAZNO,DURAZNO,20,18,2,20,18,0,2,0,0,0,18,18,0,0,62,27,35,62,27,35,0,0,0,0,0,0, ,0,1,0,0
601027017,6,1,27,17,6220,DURAZNO,DURAZNO,15,14,1,15,14,0,1,0,0,0,14,14,0,0,52,27,25,52,27,25,0,0,0,0,0,0, ,0,1,0,0
601027018,6,1,27,18,6220,DURAZNO,DURAZNO,7,7,0,7,7,0,0,0,0,0,7,7,0,0,22,10,12,22,10,12,0,0,0,0,0,0, ,0,1,0,0
601027019,6,1,27,19,6220,DURAZNO,DURAZNO,10,9,1,10,9,0,1,0,0,0,9,9,0,0,28,14,14,28,14,14,0,0,0,0,0,0, ,0,1,0,0
601027020,6,1,27,20,6220,DURAZNO,DURAZNO,2,2,0,2,2,0,0,0,0,0,2,2,0,0,11,5,6,11,5,6,0,0,0,0,0,0, ,0,1,0,0
601027021,6,1,27,21,6220,DURAZNO,DURAZNO,3,2,1,3,2,0,1,0,0,0,4,4,0,0,18,9,9,18,9,9,0,0,0,0,0,0, ,0,1,0,0
601027023,6,1,27,23,6220,DURAZNO,DURAZNO,0,0,0,0,0,0,0,0,0,0,0,0,0,0,0,0,0,0,0,0,0,0,0,0,0,0, ,0,1,0,0
601027600,6,1,27,600,6220,DURAZNO,DURAZNO,14,14,0,14,14,0,0,0,0,0,14,14,0,0,38,19,19,38,19,19,0,0,0,0,0,0, ,0,1,0,0
601027601,6,1,27,601,6220,DURAZNO,DURAZNO,43,43,0,43,43,0,0,0,0,0,43,43,0,0,148,77,71,148,77,71,0,0,0,0,0,0, ,0,1,0,0
601027602,6,1,27,602,6220,DURAZNO,DURAZNO,0,0,0,0,0,0,0,0,0,0,0,0,0,0,0,0,0,0,0,0,0,0,0,0,0,0, ,0,1,0,0
601027800,6,1,27,800,6220,DURAZNO,DURAZNO,36,29,7,36,29,0,7,0,0,0,32,32,0,0,89,48,41,89,48,41,0,0,0,0,0,0, ,0,1,0,0
601027802,6,1,27,802,6220,DURAZNO,DURAZNO,0,0,0,0,0,0,0,0,0,0,0,0,0,0,0,0,0,0,0,0,0,0,0,0,0,0, ,0,1,0,0
601027803,6,1,27,803,6220,DURAZNO,DURAZNO,10,9,1,10,9,0,1,0,0,0,9,9,0,0,21,11,10,21,11,10,0,0,0,0,0,0, ,0,1,0,0
601027804,6,1,27,804,6220,DURAZNO,DURAZNO,6,5,1,6,5,0,1,0,0,0,5,5,0,0,14,6,8,14,6,8,0,0,0,0,0,0, ,0,1,0,0
601027805,6,1,27,805,6220,DURAZNO,DURAZNO,0,0,0,0,0,0,0,0,0,0,0,0,0,0,0,0,0,0,0,0,0,0,0,0,0,0, ,0,1,0,0
601027806,6,1,27,806,6220,DURAZNO,DURAZNO,20,19,1,20,19,0,1,0,0,0,19,19,0,0,47,19,28,47,19,28,0,0,0,0,0,0, ,0,1,0,0
601027807,6,1,27,807,6220,DURAZNO,DURAZNO,11,11,0,11,11,0,0,0,0,0,11,11,0,0,27,13,14,27,13,14,0,0,0,0,0,0, ,0,1,0,0
601027808,6,1,27,808,6220,DURAZNO,DURAZNO,25,25,0,25,25,0,0,0,0,0,25,25,0,0,68,32,36,68,32,36,0,0,0,0,0,0, ,0,1,0,0
601028002,6,1,28,2,6220,DURAZNO,DURAZNO,35,31,4,35,31,0,4,0,0,0,33,33,0,0,121,58,63,121,58,63,0,0,0,0,0,0, ,0,1,0,0
601028003,6,1,28,3,6220,DURAZNO,DURAZNO,18,17,1,18,17,0,1,0,0,0,23,23,0,0,81,47,34,81,47,34,0,0,0,0,0,0, ,0,1,0,0
601028004,6,1,28,4,6220,DURAZNO,DURAZNO,3,3,0,3,3,0,0,0,0,0,3,3,0,0,5,3,2,5,3,2,0,0,0,0,0,0, ,0,1,0,0
601028005,6,1,28,5,6220,DURAZNO,DURAZNO,6,6,0,6,6,0,0,0,0,0,6,6,0,0,20,11,9,20,11,9,0,0,0,0,0,0, ,0,1,0,0
601028006,6,1,28,6,6220,DURAZNO,DURAZNO,17,16,1,17,16,0,1,0,0,0,18,18,0,0,58,26,32,58,26,32,0,0,0,0,0,0, ,0,1,0,0
601028007,6,1,28,7,6220,DURAZNO,DURAZNO,12,10,2,12,10,0,2,0,0,0,21,21,0,0,47,28,19,47,28,19,0,0,0,0,0,0, ,0,1,0,0
601028008,6,1,28,8,6220,DURAZNO,DURAZNO,21,19,2,21,19,0,2,0,0,0,19,19,0,0,64,25,39,64,25,39,0,0,0,0,0,0, ,0,1,0,0
601028011,6,1,28,11,6220,DURAZNO,DURAZNO,27,26,1,27,26,0,1,0,0,0,26,26,0,0,85,44,41,85,44,41,0,0,0,0,0,0, ,0,1,0,0
601028012,6,1,28,12,6220,DURAZNO,DURAZNO,12,12,0,12,12,0,0,0,0,0,12,12,0,0,30,13,17,30,13,17,0,0,0,0,0,0, ,0,1,0,0
601028015,6,1,28,15,6220,DURAZNO,DURAZNO,21,19,2,21,19,0,2,0,0,0,19,19,0,0,66,34,32,66,34,32,0,0,0,0,0,0, ,0,1,0,0
601028016,6,1,28,16,6220,DURAZNO,DURAZNO,26,24,2,26,24,0,2,0,0,0,26,26,0,0,99,53,46,99,53,46,0,0,0,0,0,0, ,0,1,0,0
601028017,6,1,28,17,6220,DURAZNO,DURAZNO,14,12,2,14,12,0,2,0,0,0,12,12,0,0,31,14,17,31,14,17,0,0,0,0,0,0, ,0,1,0,0
601028018,6,1,28,18,6220,DURAZNO,DURAZNO,14,14,0,14,14,0,0,0,0,0,15,15,0,0,30,19,11,30,19,11,0,0,0,0,0,0, ,0,1,0,0
601028019,6,1,28,19,6220,DURAZNO,DURAZNO,0,0,0,0,0,0,0,0,0,0,0,0,0,0,0,0,0,0,0,0,0,0,0,0,0,0, ,0,1,0,0
601028023,6,1,28,23,6220,DURAZNO,DURAZNO,19,17,2,19,17,0,2,0,0,0,18,18,0,0,62,29,33,62,29,33,0,0,0,0,0,0, ,0,1,0,0
601028024,6,1,28,24,6220,DURAZNO,DURAZNO,17,16,1,17,16,0,1,0,0,0,25,25,0,0,60,33,27,60,33,27,0,0,0,0,0,0, ,0,1,0,0
601028025,6,1,28,25,6220,DURAZNO,DURAZNO,0,0,0,0,0,0,0,0,0,0,0,0,0,0,0,0,0,0,0,0,0,0,0,0,0,0, ,0,1,0,0
601028400,6,1,28,400,6220,DURAZNO,DURAZNO,0,0,0,0,0,0,0,0,0,0,0,0,0,0,0,0,0,0,0,0,0,0,0,0,0,0, ,0,1,0,0
601028401,6,1,28,401,6220,DURAZNO,DURAZNO,0,0,0,0,0,0,0,0,0,0,0,0,0,0,0,0,0,0,0,0,0,0,0,0,0,0, ,0,1,0,0
601028402,6,1,28,402,6220,DURAZNO,DURAZNO,0,0,0,0,0,0,0,0,0,0,0,0,0,0,0,0,0,0,0,0,0,0,0,0,0,0, ,0,1,0,0
601028403,6,1,28,403,6220,DURAZNO,DURAZNO,0,0,0,0,0,0,0,0,0,0,0,0,0,0,0,0,0,0,0,0,0,0,0,0,0,0, ,0,1,0,0
601028404,6,1,28,404,6220,DURAZNO,DURAZNO,0,0,0,0,0,0,0,0,0,0,0,0,0,0,0,0,0,0,0,0,0,0,0,0,0,0, ,0,1,0,0
601028405,6,1,28,405,6220,DURAZNO,DURAZNO,0,0,0,0,0,0,0,0,0,0,0,0,0,0,0,0,0,0,0,0,0,0,0,0,0,0, ,0,1,0,0
601028600,6,1,28,600,6220,DURAZNO,DURAZNO,20,18,2,20,18,0,2,0,0,0,18,18,0,0,66,31,35,66,31,35,0,0,0,0,0,0, ,0,1,0,0
601028602,6,1,28,602,6220,DURAZNO,DURAZNO,0,0,0,0,0,0,0,0,0,0,0,0,0,0,0,0,0,0,0,0,0,0,0,0,0,0, ,0,1,0,0
601028603,6,1,28,603,6220,DURAZNO,DURAZNO,22,22,0,22,22,0,0,0,0,0,22,22,0,0,84,40,44,84,40,44,0,0,0,0,0,0, ,0,1,0,0
601028604,6,1,28,604,6220,DURAZNO,DURAZNO,2,1,1,2,1,0,1,0,0,0,1,1,0,0,4,3,1,4,3,1,0,0,0,0,0,0, ,0,1,0,0
601028605,6,1,28,605,6220,DURAZNO,DURAZNO,0,0,0,0,0,0,0,0,0,0,0,0,0,0,0,0,0,0,0,0,0,0,0,0,0,0, ,0,1,0,0
601028606,6,1,28,606,6220,DURAZNO,DURAZNO,5,5,0,5,5,0,0,0,0,0,5,5,0,0,17,8,9,17,8,9,0,0,0,0,0,0, ,0,1,0,0
601028607,6,1,28,607,6220,DURAZNO,DURAZNO,14,13,1,14,13,0,1,0,0,0,13,13,0,0,44,25,19,44,25,19,0,0,0,0,0,0, ,0,1,0,0
601028608,6,1,28,608,6220,DURAZNO,DURAZNO,16,12,4,16,12,0,4,0,0,0,12,12,0,0,28,15,13,28,15,13,0,0,0,0,0,0, ,0,1,0,0
601028609,6,1,28,609,6220,DURAZNO,DURAZNO,6,6,0,6,6,0,0,0,0,0,6,6,0,0,15,8,7,15,8,7,0,0,0,0,0,0, ,0,1,0,0
601028610,6,1,28,610,6220,DURAZNO,DURAZNO,16,15,1,16,15,0,1,0,0,0,15,15,0,0,47,28,19,47,28,19,0,0,0,0,0,0, ,0,1,0,0
601028611,6,1,28,611,6220,DURAZNO,DURAZNO,17,17,0,17,17,0,0,0,0,0,17,17,0,0,40,19,21,40,19,21,0,0,0,0,0,0, ,0,1,0,0
601028612,6,1,28,612,6220,DURAZNO,DURAZNO,12,10,2,12,10,0,2,0,0,0,10,10,0,0,23,10,13,23,10,13,0,0,0,0,0,0, ,0,1,0,0
601028613,6,1,28,613,6220,DURAZNO,DURAZNO,6,6,0,6,6,0,0,0,0,0,6,6,0,0,15,5,10,15,5,10,0,0,0,0,0,0, ,0,1,0,0
601028614,6,1,28,614,6220,DURAZNO,DURAZNO,0,0,0,0,0,0,0,0,0,0,0,0,0,0,0,0,0,0,0,0,0,0,0,0,0,0, ,0,1,0,0
601028615,6,1,28,615,6220,DURAZNO,DURAZNO,1,1,0,1,1,0,0,0,0,0,1,1,0,0,1,1,0,1,1,0,0,0,0,0,0,0, ,0,1,0,0
601028616,6,1,28,616,6220,DURAZNO,DURAZNO,3,2,1,3,2,0,1,0,0,0,2,2,0,0,9,6,3,9,6,3,0,0,0,0,0,0, ,0,15,0,0
601028617,6,1,28,617,6220,DURAZNO,DURAZNO,1,1,0,1,1,0,0,0,0,0,1,1,0,0,1,1,0,1,1,0,0,0,0,0,0,0, ,0,15,0,0
601028618,6,1,28,618,6220,DURAZNO,DURAZNO,21,20,1,21,20,0,1,0,0,0,20,20,0,0,68,35,33,68,35,33,0,0,0,0,0,0, ,0,15,0,0
601028619,6,1,28,619,6220,DURAZNO,DURAZNO,19,19,0,19,19,0,0,0,0,0,19,19,0,0,88,45,43,88,45,43,0,0,0,0,0,0, ,0,15,0,0
601028620,6,1,28,620,6220,DURAZNO,DURAZNO,10,10,0,10,10,0,0,0,0,0,10,10,0,0,50,30,20,50,30,20,0,0,0,0,0,0, ,0,15,0,0
601028621,6,1,28,621,6220,DURAZNO,DURAZNO,30,28,2,30,28,0,2,0,0,0,28,28,0,0,126,61,65,126,61,65,0,0,0,0,0,0, ,0,15,0,0
601028622,6,1,28,622,6220,DURAZNO,DURAZNO,29,21,8,29,21,0,8,0,0,0,21,21,0,0,87,38,49,87,38,49,0,0,0,0,0,0, ,0,15,0,0
601028623,6,1,28,623,6220,DURAZNO,DURAZNO,1,1,0,1,1,0,0,0,0,0,1,1,0,0,2,2,0,2,2,0,0,0,0,0,0,0, ,0,15,0,0
601028700,6,1,28,700,6220,DURAZNO,DURAZNO,1,1,0,1,1,0,0,0,0,0,1,1,0,0,6,3,3,6,3,3,0,0,0,0,0,0, ,0,1,0,0
601028701,6,1,28,701,6220,DURAZNO,DURAZNO,20,20,0,20,20,0,0,0,0,0,24,24,0,0,105,48,57,105,48,57,0,0,0,0,0,0, ,0,1,0,0
601028702,6,1,28,702,6220,DURAZNO,DURAZNO,19,13,6,19,13,0,6,0,0,0,13,13,0,0,50,28,22,50,28,22,0,0,0,0,0,0, ,0,1,0,0
601028703,6,1,28,703,6220,DURAZNO,DURAZNO,7,6,1,7,6,0,1,0,0,0,6,6,0,0,29,13,16,29,13,16,0,0,0,0,0,0, ,0,1,0,0
601028704,6,1,28,704,6220,DURAZNO,DURAZNO,18,11,7,18,11,0,7,0,0,0,11,11,0,0,37,19,18,37,19,18,0,0,0,0,0,0, ,0,1,0,0
601028705,6,1,28,705,6220,DURAZNO,DURAZNO,9,5,4,9,5,0,4,0,0,0,5,5,0,0,13,7,6,13,7,6,0,0,0,0,0,0, ,0,1,0,0
601028800,6,1,28,800,6220,DURAZNO,DURAZNO,23,22,1,23,22,0,1,0,0,0,22,22,0,0,81,35,46,81,35,46,0,0,0,0,0,0, ,0,1,0,0
601028802,6,1,28,802,6220,DURAZNO,DURAZNO,1,1,0,1,1,0,0,0,0,0,1,1,0,0,3,2,1,3,2,1,0,0,0,0,0,0, ,0,1,0,0
601028806,6,1,28,806,6220,DURAZNO,DURAZNO,0,0,0,0,0,0,0,0,0,0,0,0,0,0,0,0,0,0,0,0,0,0,0,0,0,0, ,0,1,0,0
601028807,6,1,28,807,6220,DURAZNO,DURAZNO,10,10,0,10,10,0,0,0,0,0,10,10,0,0,31,15,16,31,15,16,0,0,0,0,0,0, ,0,1,0,0
601028808,6,1,28,808,6220,DURAZNO,DURAZNO,5,4,1,5,4,0,1,0,0,0,4,4,0,0,15,5,10,15,5,10,0,0,0,0,0,0, ,0,1,0,0
601028810,6,1,28,810,6220,DURAZNO,DURAZNO,10,10,0,10,10,0,0,0,0,0,11,11,0,0,36,13,23,36,13,23,0,0,0,0,0,0, ,0,1,0,0
601028811,6,1,28,811,6220,DURAZNO,DURAZNO,16,14,2,16,14,0,2,0,0,0,14,14,0,0,75,36,39,75,36,39,0,0,0,0,0,0, ,0,1,0,0
601028812,6,1,28,812,6220,DURAZNO,DURAZNO,0,0,0,0,0,0,0,0,0,0,0,0,0,0,0,0,0,0,0,0,0,0,0,0,0,0, ,0,1,0,0
601028813,6,1,28,813,6220,DURAZNO,DURAZNO,19,19,0,19,19,0,0,0,0,0,19,19,0,0,68,34,34,68,34,34,0,0,0,0,0,0, ,0,1,0,0
601028814,6,1,28,814,6220,DURAZNO,DURAZNO,24,23,1,24,23,0,1,0,0,0,24,24,0,0,91,43,48,91,43,48,0,0,0,0,0,0, ,0,1,0,0
601028815,6,1,28,815,6220,DURAZNO,DURAZNO,24,24,0,24,24,0,0,0,0,0,24,24,0,0,86,41,45,86,41,45,0,0,0,0,0,0, ,0,1,0,0
601028816,6,1,28,816,6220,DURAZNO,DURAZNO,24,22,2,24,22,0,2,0,0,0,22,22,0,0,73,36,37,73,36,37,0,0,0,0,0,0, ,0,1,0,0
601028817,6,1,28,817,6220,DURAZNO,DURAZNO,20,20,0,20,20,0,0,0,0,0,24,24,0,0,111,60,51,111,60,51,0,0,0,0,0,0, ,0,1,0,0
601028818,6,1,28,818,6220,DURAZNO,DURAZNO,18,18,0,18,18,0,0,0,0,0,19,19,0,0,88,42,46,88,42,46,0,0,0,0,0,0, ,0,1,0,0
601028819,6,1,28,819,6220,DURAZNO,DURAZNO,22,21,1,22,21,0,1,0,0,0,22,22,0,0,96,46,50,96,46,50,0,0,0,0,0,0, ,0,1,0,0
601028820,6,1,28,820,6220,DURAZNO,DURAZNO,23,23,0,23,23,0,0,0,0,0,23,23,0,0,82,38,44,82,38,44,0,0,0,0,0,0, ,0,1,0,0
601028821,6,1,28,821,6220,DURAZNO,DURAZNO,18,18,0,18,18,0,0,0,0,0,18,18,0,0,64,31,33,64,31,33,0,0,0,0,0,0, ,0,1,0,0
601028822,6,1,28,822,6220,DURAZNO,DURAZNO,17,17,0,17,17,0,0,0,0,0,17,17,0,0,69,34,35,69,34,35,0,0,0,0,0,0, ,0,1,0,0
601028823,6,1,28,823,6220,DURAZNO,DURAZNO,20,20,0,20,20,0,0,0,0,0,21,21,0,0,107,53,54,107,53,54,0,0,0,0,0,0, ,0,1,0,0
601029003,6,1,29,3,6220,DURAZNO,DURAZNO,7,7,0,7,7,0,0,0,0,0,7,7,0,0,18,13,5,18,13,5,0,0,0,0,0,0, ,0,1,0,0
601029004,6,1,29,4,6220,DURAZNO,DURAZNO,20,18,2,20,18,0,2,0,0,0,18,18,0,0,77,33,44,77,33,44,0,0,0,0,0,0, ,0,1,0,0
601029005,6,1,29,5,6220,DURAZNO,DURAZNO,12,9,3,12,9,0,3,0,0,0,9,9,0,0,24,8,16,24,8,16,0,0,0,0,0,0, ,0,1,0,0
601029006,6,1,29,6,6220,DURAZNO,DURAZNO,14,13,1,14,13,0,1,0,0,0,13,13,0,0,51,26,25,51,26,25,0,0,0,0,0,0, ,0,1,0,0
601029007,6,1,29,7,6220,DURAZNO,DURAZNO,21,19,2,21,19,0,2,0,0,0,19,19,0,0,64,32,32,64,32,32,0,0,0,0,0,0, ,0,1,0,0
601029008,6,1,29,8,6220,DURAZNO,DURAZNO,36,30,6,36,30,0,6,0,0,0,30,30,0,0,101,49,52,101,49,52,0,0,0,0,0,0, ,0,1,0,0
601029009,6,1,29,9,6220,DURAZNO,DURAZNO,13,12,1,13,12,0,1,0,0,0,12,12,0,0,57,30,27,57,30,27,0,0,0,0,0,0, ,0,1,0,0
601029011,6,1,29,11,6220,DURAZNO,DURAZNO,0,0,0,0,0,0,0,0,0,0,0,0,0,0,0,0,0,0,0,0,0,0,0,0,0,0, ,0,1,0,0
601029012,6,1,29,12,6220,DURAZNO,DURAZNO,0,0,0,0,0,0,0,0,0,0,0,0,0,0,0,0,0,0,0,0,0,0,0,0,0,0, ,0,1,0,0
601029013,6,1,29,13,6220,DURAZNO,DURAZNO,0,0,0,0,0,0,0,0,0,0,0,0,0,0,0,0,0,0,0,0,0,0,0,0,0,0, ,0,1,0,0
601029016,6,1,29,16,6220,DURAZNO,DURAZNO,24,20,4,24,20,0,4,0,0,0,20,20,0,0,81,40,41,81,40,41,0,0,0,0,0,0, ,0,1,0,0
601029018,6,1,29,18,6220,DURAZNO,DURAZNO,18,10,8,18,10,0,8,0,0,0,10,10,0,0,27,13,14,27,13,14,0,0,0,0,0,0, ,0,1,0,0
601029019,6,1,29,19,6220,DURAZNO,DURAZNO,27,18,9,27,18,0,9,0,0,0,18,18,0,0,47,27,20,47,27,20,0,0,0,0,0,0, ,0,1,0,0
601029020,6,1,29,20,6220,DURAZNO,DURAZNO,12,12,0,12,12,0,0,0,0,0,12,12,0,0,43,23,20,43,23,20,0,0,0,0,0,0, ,0,1,0,0
601029021,6,1,29,21,6220,DURAZNO,DURAZNO,7,6,1,7,6,0,1,0,0,0,6,6,0,0,22,12,10,22,12,10,0,0,0,0,0,0, ,0,1,0,0
601029022,6,1,29,22,6220,DURAZNO,DURAZNO,6,6,0,6,6,0,0,0,0,0,6,6,0,0,29,13,16,29,13,16,0,0,0,0,0,0, ,0,1,0,0
601029023,6,1,29,23,6220,DURAZNO,DURAZNO,13,10,3,13,10,0,3,0,0,0,11,11,0,0,29,15,14,29,15,14,0,0,0,0,0,0, ,0,1,0,0
601029110,6,1,29,110,6220,DURAZNO,DURAZNO,16,15,1,16,15,0,1,0,0,0,15,15,0,0,70,35,35,70,35,35,0,0,0,0,0,0, ,0,1,0,0
601029210,6,1,29,210,6220,DURAZNO,DURAZNO,8,8,0,8,8,0,0,0,0,0,8,8,0,0,28,17,11,28,17,11,0,0,0,0,0,0, ,0,1,0,0
601029401,6,1,29,401,6220,DURAZNO,DURAZNO,0,0,0,0,0,0,0,0,0,0,0,0,0,0,0,0,0,0,0,0,0,0,0,0,0,0, ,0,1,0,0
601029402,6,1,29,402,6220,DURAZNO,DURAZNO,0,0,0,0,0,0,0,0,0,0,0,0,0,0,0,0,0,0,0,0,0,0,0,0,0,0, ,0,1,0,0
601029403,6,1,29,403,6220,DURAZNO,DURAZNO,0,0,0,0,0,0,0,0,0,0,0,0,0,0,0,0,0,0,0,0,0,0,0,0,0,0, ,0,1,0,0
601029404,6,1,29,404,6220,DURAZNO,DURAZNO,0,0,0,0,0,0,0,0,0,0,0,0,0,0,0,0,0,0,0,0,0,0,0,0,0,0, ,0,1,0,0
601029405,6,1,29,405,6220,DURAZNO,DURAZNO,0,0,0,0,0,0,0,0,0,0,0,0,0,0,0,0,0,0,0,0,0,0,0,0,0,0, ,0,1,0,0
601029406,6,1,29,406,6220,DURAZNO,DURAZNO,0,0,0,0,0,0,0,0,0,0,0,0,0,0,0,0,0,0,0,0,0,0,0,0,0,0, ,0,1,0,0
601029407,6,1,29,407,6220,DURAZNO,DURAZNO,0,0,0,0,0,0,0,0,0,0,0,0,0,0,0,0,0,0,0,0,0,0,0,0,0,0, ,0,1,0,0
601029408,6,1,29,408,6220,DURAZNO,DURAZNO,0,0,0,0,0,0,0,0,0,0,0,0,0,0,0,0,0,0,0,0,0,0,0,0,0,0, ,0,1,0,0
601029409,6,1,29,409,6220,DURAZNO,DURAZNO,0,0,0,0,0,0,0,0,0,0,0,0,0,0,0,0,0,0,0,0,0,0,0,0,0,0, ,0,1,0,0
601029410,6,1,29,410,6220,DURAZNO,DURAZNO,0,0,0,0,0,0,0,0,0,0,0,0,0,0,0,0,0,0,0,0,0,0,0,0,0,0, ,0,1,0,0
601029411,6,1,29,411,6220,DURAZNO,DURAZNO,0,0,0,0,0,0,0,0,0,0,0,0,0,0,0,0,0,0,0,0,0,0,0,0,0,0, ,0,1,0,0
601029412,6,1,29,412,6220,DURAZNO,DURAZNO,0,0,0,0,0,0,0,0,0,0,0,0,0,0,0,0,0,0,0,0,0,0,0,0,0,0, ,0,1,0,0
601029600,6,1,29,600,6220,DURAZNO,DURAZNO,0,0,0,0,0,0,0,0,0,0,0,0,0,0,0,0,0,0,0,0,0,0,0,0,0,0, ,0,1,0,0
601029601,6,1,29,601,6220,DURAZNO,DURAZNO,3,2,1,3,2,0,1,0,0,0,2,2,0,0,6,3,3,6,3,3,0,0,0,0,0,0, ,0,1,0,0
601029602,6,1,29,602,6220,DURAZNO,DURAZNO,0,0,0,0,0,0,0,0,0,0,0,0,0,0,0,0,0,0,0,0,0,0,0,0,0,0, ,0,1,0,0
601029603,6,1,29,603,6220,DURAZNO,DURAZNO,0,0,0,0,0,0,0,0,0,0,0,0,0,0,0,0,0,0,0,0,0,0,0,0,0,0, ,0,1,0,0
601029604,6,1,29,604,6220,DURAZNO,DURAZNO,0,0,0,0,0,0,0,0,0,0,0,0,0,0,0,0,0,0,0,0,0,0,0,0,0,0, ,0,1,0,0
601029605,6,1,29,605,6220,DURAZNO,DURAZNO,0,0,0,0,0,0,0,0,0,0,0,0,0,0,0,0,0,0,0,0,0,0,0,0,0,0, ,0,1,0,0
601029606,6,1,29,606,6220,DURAZNO,DURAZNO,8,6,2,8,6,0,2,0,0,0,6,6,0,0,34,20,14,34,20,14,0,0,0,0,0,0, ,0,1,0,0
601029607,6,1,29,607,6220,DURAZNO,DURAZNO,0,0,0,0,0,0,0,0,0,0,0,0,0,0,0,0,0,0,0,0,0,0,0,0,0,0, ,0,1,0,0
601029608,6,1,29,608,6220,DURAZNO,DURAZNO,6,4,2,6,4,0,2,0,0,0,4,4,0,0,15,7,8,15,7,8,0,0,0,0,0,0, ,0,1,0,0
601029609,6,1,29,609,6220,DURAZNO,DURAZNO,0,0,0,0,0,0,0,0,0,0,0,0,0,0,0,0,0,0,0,0,0,0,0,0,0,0, ,0,1,0,0
601029610,6,1,29,610,6220,DURAZNO,DURAZNO,0,0,0,0,0,0,0,0,0,0,0,0,0,0,0,0,0,0,0,0,0,0,0,0,0,0, ,0,1,0,0
601029611,6,1,29,611,6220,DURAZNO,DURAZNO,0,0,0,0,0,0,0,0,0,0,0,0,0,0,0,0,0,0,0,0,0,0,0,0,0,0, ,0,1,0,0
601029612,6,1,29,612,6220,DURAZNO,DURAZNO,0,0,0,0,0,0,0,0,0,0,0,0,0,0,0,0,0,0,0,0,0,0,0,0,0,0, ,0,1,0,0
601029613,6,1,29,613,6220,DURAZNO,DURAZNO,0,0,0,0,0,0,0,0,0,0,0,0,0,0,0,0,0,0,0,0,0,0,0,0,0,0, ,0,1,0,0
601029614,6,1,29,614,6220,DURAZNO,DURAZNO,13,13,0,13,13,0,0,0,0,0,13,13,0,0,42,21,21,42,21,21,0,0,0,0,0,0, ,0,1,0,0
601029615,6,1,29,615,6220,DURAZNO,DURAZNO,0,0,0,0,0,0,0,0,0,0,0,0,0,0,0,0,0,0,0,0,0,0,0,0,0,0, ,0,1,0,0
601029616,6,1,29,616,6220,DURAZNO,DURAZNO,0,0,0,0,0,0,0,0,0,0,0,0,0,0,0,0,0,0,0,0,0,0,0,0,0,0, ,0,1,0,0
601029801,6,1,29,801,6220,DURAZNO,DURAZNO,16,14,2,16,14,0,2,0,0,0,14,14,0,0,36,16,20,36,16,20,0,0,0,0,0,0, ,0,1,0,0
601029804,6,1,29,804,6220,DURAZNO,DURAZNO,4,3,1,4,3,0,1,0,0,0,3,3,0,0,9,5,4,9,5,4,0,0,0,0,0,0, ,0,1,0,0
601029805,6,1,29,805,6220,DURAZNO,DURAZNO,11,9,2,11,9,0,2,0,0,0,9,9,0,0,29,16,13,29,16,13,0,0,0,0,0,0, ,0,1,0,0
601029806,6,1,29,806,6220,DURAZNO,DURAZNO,15,11,4,15,11,0,4,0,0,0,11,11,0,0,40,18,22,40,18,22,0,0,0,0,0,0, ,0,1,0,0
601029808,6,1,29,808,6220,DURAZNO,DURAZNO,9,9,0,9,9,0,0,0,0,0,9,9,0,0,25,9,16,25,9,16,0,0,0,0,0,0, ,0,1,0,0
601029809,6,1,29,809,6220,DURAZNO,DURAZNO,0,0,0,0,0,0,0,0,0,0,0,0,0,0,0,0,0,0,0,0,0,0,0,0,0,0, ,0,1,0,0
601029810,6,1,29,810,6220,DURAZNO,DURAZNO,4,4,0,4,4,0,0,0,0,0,4,4,0,0,16,6,10,16,6,10,0,0,0,0,0,0, ,0,1,0,0
601029811,6,1,29,811,6220,DURAZNO,DURAZNO,3,1,2,3,1,0,2,0,0,0,1,1,0,0,6,2,4,6,2,4,0,0,0,0,0,0, ,0,1,0,0
601029812,6,1,29,812,6220,DURAZNO,DURAZNO,2,2,0,2,2,0,0,0,0,0,2,2,0,0,9,4,5,9,4,5,0,0,0,0,0,0, ,0,1,0,0
601029813,6,1,29,813,6220,DURAZNO,DURAZNO,5,4,1,5,4,0,1,0,0,0,4,4,0,0,15,8,7,15,8,7,0,0,0,0,0,0, ,0,1,0,0
601029814,6,1,29,814,6220,DURAZNO,DURAZNO,2,1,1,2,1,0,1,0,0,0,1,1,0,0,3,2,1,3,2,1,0,0,0,0,0,0, ,0,1,0,0
601029815,6,1,29,815,6220,DURAZNO,DURAZNO,5,4,1,5,4,0,1,0,0,0,4,4,0,0,15,10,5,15,10,5,0,0,0,0,0,0, ,0,1,0,0
601029816,6,1,29,816,6220,DURAZNO,DURAZNO,0,0,0,0,0,0,0,0,0,0,0,0,0,0,0,0,0,0,0,0,0,0,0,0,0,0, ,0,1,0,0
601031002,6,1,31,2,6220,DURAZNO,DURAZNO,26,22,4,26,22,0,4,0,0,0,22,22,0,0,75,39,36,75,39,36,0,0,0,0,0,0, ,0,1,0,0
601031004,6,1,31,4,6220,DURAZNO,DURAZNO,13,11,2,13,11,0,2,0,0,0,11,11,0,0,40,25,15,40,25,15,0,0,0,0,0,0, ,0,1,0,0
601031005,6,1,31,5,6220,DURAZNO,DURAZNO,34,17,17,34,17,0,17,0,0,0,17,17,0,0,52,30,22,52,30,22,0,0,0,0,0,0, ,0,1,0,0
601031006,6,1,31,6,6220,DURAZNO,DURAZNO,30,21,9,30,21,0,9,0,0,0,21,21,0,0,85,44,41,85,44,41,0,0,0,0,0,0, ,0,1,0,0
601031007,6,1,31,7,6220,DURAZNO,DURAZNO,27,21,6,27,21,0,6,0,0,0,21,21,0,0,81,35,46,81,35,46,0,0,0,0,0,0, ,0,1,0,0
601031008,6,1,31,8,6220,DURAZNO,DURAZNO,19,16,3,19,16,0,3,0,0,0,16,16,0,0,70,37,33,70,37,33,0,0,0,0,0,0, ,0,1,0,0
601031009,6,1,31,9,6220,DURAZNO,DURAZNO,6,6,0,6,6,0,0,0,0,0,6,6,0,0,16,7,9,16,7,9,0,0,0,0,0,0, ,0,1,0,0
601031011,6,1,31,11,6220,DURAZNO,DURAZNO,10,9,1,10,9,0,1,0,0,0,9,9,0,0,38,17,21,38,17,21,0,0,0,0,0,0, ,0,1,0,0
601031012,6,1,31,12,6220,DURAZNO,DURAZNO,30,26,4,30,26,0,4,0,0,0,26,26,0,0,80,37,43,80,37,43,0,0,0,0,0,0, ,0,1,0,0
601031014,6,1,31,14,6220,DURAZNO,DURAZNO,33,28,5,33,28,0,5,0,0,0,28,28,0,0,109,54,55,109,54,55,0,0,0,0,0,0, ,0,1,0,0
601031400,6,1,31,400,6220,DURAZNO,DURAZNO,0,0,0,0,0,0,0,0,0,0,0,0,0,0,0,0,0,0,0,0,0,0,0,0,0,0, ,0,1,0,0
601031401,6,1,31,401,6220,DURAZNO,DURAZNO,0,0,0,0,0,0,0,0,0,0,0,0,0,0,0,0,0,0,0,0,0,0,0,0,0,0, ,0,1,0,0
601031402,6,1,31,402,6220,DURAZNO,DURAZNO,0,0,0,0,0,0,0,0,0,0,0,0,0,0,0,0,0,0,0,0,0,0,0,0,0,0, ,0,1,0,0
601031403,6,1,31,403,6220,DURAZNO,DURAZNO,0,0,0,0,0,0,0,0,0,0,0,0,0,0,0,0,0,0,0,0,0,0,0,0,0,0, ,0,1,0,0
601031404,6,1,31,404,6220,DURAZNO,DURAZNO,0,0,0,0,0,0,0,0,0,0,0,0,0,0,0,0,0,0,0,0,0,0,0,0,0,0, ,0,1,0,0
601031405,6,1,31,405,6220,DURAZNO,DURAZNO,0,0,0,0,0,0,0,0,0,0,0,0,0,0,0,0,0,0,0,0,0,0,0,0,0,0, ,0,1,0,0
601031600,6,1,31,600,6220,DURAZNO,DURAZNO,8,6,2,8,6,0,2,0,0,0,6,6,0,0,19,7,12,19,7,12,0,0,0,0,0,0, ,0,1,0,0
601031601,6,1,31,601,6220,DURAZNO,DURAZNO,0,0,0,0,0,0,0,0,0,0,0,0,0,0,0,0,0,0,0,0,0,0,0,0,0,0, ,0,1,0,0
601031602,6,1,31,602,6220,DURAZNO,DURAZNO,6,5,1,6,5,0,1,0,0,0,6,6,0,0,18,11,7,18,11,7,0,0,0,0,0,0, ,0,1,0,0
601031603,6,1,31,603,6220,DURAZNO,DURAZNO,0,0,0,0,0,0,0,0,0,0,0,0,0,0,0,0,0,0,0,0,0,0,0,0,0,0, ,0,1,0,0
601031604,6,1,31,604,6220,DURAZNO,DURAZNO,16,14,2,16,14,0,2,0,0,0,14,14,0,0,51,24,27,51,24,27,0,0,0,0,0,0, ,0,1,0,0
601031605,6,1,31,605,6220,DURAZNO,DURAZNO,27,19,8,27,19,0,8,0,0,0,19,19,0,0,51,26,25,51,26,25,0,0,0,0,0,0, ,0,1,0,0
601031800,6,1,31,800,6220,DURAZNO,DURAZNO,38,28,10,38,28,0,10,0,0,0,29,29,0,0,112,51,61,112,51,61,0,0,0,0,0,0, ,0,1,0,0
601031801,6,1,31,801,6220,DURAZNO,DURAZNO,49,42,7,49,42,0,7,0,0,0,42,42,0,0,160,80,80,160,80,80,0,0,0,0,0,0, ,0,1,0,0
601032002,6,1,32,2,6220,DURAZNO,DURAZNO,38,33,5,38,33,0,5,0,0,0,33,33,0,0,102,58,44,102,58,44,0,0,0,0,0,0, ,0,1,0,0
601032007,6,1,32,7,6220,DURAZNO,DURAZNO,9,5,4,9,5,0,4,0,0,0,5,5,0,0,11,5,6,11,5,6,0,0,0,0,0,0, ,0,1,0,0
601032009,6,1,32,9,6220,DURAZNO,DURAZNO,15,10,5,15,10,0,5,0,0,0,10,10,0,0,22,13,9,22,13,9,0,0,0,0,0,0, ,0,1,0,0
601032600,6,1,32,600,6220,DURAZNO,DURAZNO,18,15,3,18,15,0,3,0,0,0,15,15,0,0,46,23,23,46,23,23,0,0,0,0,0,0, ,0,1,0,0
601032800,6,1,32,800,6220,DURAZNO,DURAZNO,5,3,2,5,3,0,2,0,0,0,3,3,0,0,12,5,7,12,5,7,0,0,0,0,0,0, ,0,1,0,0
601032801,6,1,32,801,6220,DURAZNO,DURAZNO,2,2,0,2,2,0,0,0,0,0,2,2,0,0,6,3,3,6,3,3,0,0,0,0,0,0, ,0,1,0,0
601032802,6,1,32,802,6220,DURAZNO,DURAZNO,0,0,0,0,0,0,0,0,0,0,0,0,0,0,0,0,0,0,0,0,0,0,0,0,0,0, ,0,1,0,0
601032803,6,1,32,803,6220,DURAZNO,DURAZNO,0,0,0,0,0,0,0,0,0,0,0,0,0,0,0,0,0,0,0,0,0,0,0,0,0,0, ,0,1,0,0
601033004,6,1,33,4,6220,DURAZNO,DURAZNO,0,0,0,0,0,0,0,0,0,0,0,0,0,0,0,0,0,0,0,0,0,0,0,0,0,0, ,0,1,0,0
601033007,6,1,33,7,6220,DURAZNO,DURAZNO,13,13,0,13,13,0,0,0,0,0,13,13,0,0,56,29,27,56,29,27,0,0,0,0,0,0, ,0,1,0,0
601033008,6,1,33,8,6220,DURAZNO,DURAZNO,24,21,3,24,21,0,3,0,0,0,23,23,0,0,94,48,46,94,48,46,0,0,0,0,0,0, ,0,1,0,0
601033010,6,1,33,10,6220,DURAZNO,DURAZNO,26,23,3,26,23,0,3,0,0,0,23,23,0,0,79,41,38,79,41,38,0,0,0,0,0,0, ,0,1,0,0
601033012,6,1,33,12,6220,DURAZNO,DURAZNO,0,0,0,0,0,0,0,0,0,0,0,0,0,0,0,0,0,0,0,0,0,0,0,0,0,0, ,0,1,0,0
601033018,6,1,33,18,6220,DURAZNO,DURAZNO,0,0,0,0,0,0,0,0,0,0,0,0,0,0,0,0,0,0,0,0,0,0,0,0,0,0, ,0,1,0,0
601033019,6,1,33,19,6220,DURAZNO,DURAZNO,0,0,0,0,0,0,0,0,0,0,0,0,0,0,0,0,0,0,0,0,0,0,0,0,0,0, ,0,1,0,0
601033020,6,1,33,20,6220,DURAZNO,DURAZNO,1,0,1,1,0,0,1,0,0,0,0,0,0,0,0,0,0,0,0,0,0,0,0,0,0,0, ,0,1,0,0
601033400,6,1,33,400,6220,DURAZNO,DURAZNO,0,0,0,0,0,0,0,0,0,0,0,0,0,0,0,0,0,0,0,0,0,0,0,0,0,0, ,0,1,0,0
601033401,6,1,33,401,6220,DURAZNO,DURAZNO,0,0,0,0,0,0,0,0,0,0,0,0,0,0,0,0,0,0,0,0,0,0,0,0,0,0, ,0,1,0,0
601033402,6,1,33,402,6220,DURAZNO,DURAZNO,0,0,0,0,0,0,0,0,0,0,0,0,0,0,0,0,0,0,0,0,0,0,0,0,0,0, ,0,1,0,0
601033403,6,1,33,403,6220,DURAZNO,DURAZNO,0,0,0,0,0,0,0,0,0,0,0,0,0,0,0,0,0,0,0,0,0,0,0,0,0,0, ,0,1,0,0
601033500,6,1,33,500,6220,DURAZNO,DURAZNO,0,0,0,0,0,0,0,0,0,0,0,0,0,0,0,0,0,0,0,0,0,0,0,0,0,0, ,0,1,0,0
601033501,6,1,33,501,6220,DURAZNO,DURAZNO,0,0,0,0,0,0,0,0,0,0,0,0,0,0,0,0,0,0,0,0,0,0,0,0,0,0, ,0,1,0,0
601033502,6,1,33,502,6220,DURAZNO,DURAZNO,0,0,0,0,0,0,0,0,0,0,0,0,0,0,0,0,0,0,0,0,0,0,0,0,0,0, ,0,1,0,0
601033503,6,1,33,503,6220,DURAZNO,DURAZNO,0,0,0,0,0,0,0,0,0,0,0,0,0,0,0,0,0,0,0,0,0,0,0,0,0,0, ,0,1,0,0
601033504,6,1,33,504,6220,DURAZNO,DURAZNO,0,0,0,0,0,0,0,0,0,0,0,0,0,0,0,0,0,0,0,0,0,0,0,0,0,0, ,0,1,0,0
601033600,6,1,33,600,6220,DURAZNO,DURAZNO,0,0,0,0,0,0,0,0,0,0,0,0,0,0,0,0,0,0,0,0,0,0,0,0,0,0, ,0,1,0,0
601033601,6,1,33,601,6220,DURAZNO,DURAZNO,29,24,5,29,24,0,5,0,0,0,24,24,0,0,65,26,39,65,26,39,0,0,0,0,0,0, ,0,1,0,0
601033602,6,1,33,602,6220,DURAZNO,DURAZNO,0,0,0,0,0,0,0,0,0,0,0,0,0,0,0,0,0,0,0,0,0,0,0,0,0,0, ,0,1,0,0
601033603,6,1,33,603,6220,DURAZNO,DURAZNO,0,0,0,0,0,0,0,0,0,0,0,0,0,0,0,0,0,0,0,0,0,0,0,0,0,0, ,0,1,0,0
601033604,6,1,33,604,6220,DURAZNO,DURAZNO,8,8,0,8,8,0,0,0,0,0,8,8,0,0,37,19,18,37,19,18,0,0,0,0,0,0, ,0,1,0,0
601033605,6,1,33,605,6220,DURAZNO,DURAZNO,0,0,0,0,0,0,0,0,0,0,0,0,0,0,0,0,0,0,0,0,0,0,0,0,0,0, ,0,1,0,0
601033606,6,1,33,606,6220,DURAZNO,DURAZNO,18,16,2,18,16,0,2,0,0,0,19,19,0,0,54,21,33,54,21,33,0,0,0,0,0,0, ,0,1,0,0
601033607,6,1,33,607,6220,DURAZNO,DURAZNO,0,0,0,0,0,0,0,0,0,0,0,0,0,0,0,0,0,0,0,0,0,0,0,0,0,0, ,0,1,0,0
601033608,6,1,33,608,6220,DURAZNO,DURAZNO,0,0,0,0,0,0,0,0,0,0,0,0,0,0,0,0,0,0,0,0,0,0,0,0,0,0, ,0,1,0,0
601033800,6,1,33,800,6220,DURAZNO,DURAZNO,0,0,0,0,0,0,0,0,0,0,0,0,0,0,0,0,0,0,0,0,0,0,0,0,0,0, ,0,1,0,0
601033801,6,1,33,801,6220,DURAZNO,DURAZNO,0,0,0,0,0,0,0,0,0,0,0,0,0,0,0,0,0,0,0,0,0,0,0,0,0,0, ,0,1,0,0
601033802,6,1,33,802,6220,DURAZNO,DURAZNO,0,0,0,0,0,0,0,0,0,0,0,0,0,0,0,0,0,0,0,0,0,0,0,0,0,0, ,0,1,0,0
601033803,6,1,33,803,6220,DURAZNO,DURAZNO,0,0,0,0,0,0,0,0,0,0,0,0,0,0,0,0,0,0,0,0,0,0,0,0,0,0, ,0,1,0,0
601033804,6,1,33,804,6220,DURAZNO,DURAZNO,0,0,0,0,0,0,0,0,0,0,0,0,0,0,0,0,0,0,0,0,0,0,0,0,0,0, ,0,1,0,0
601033806,6,1,33,806,6220,DURAZNO,DURAZNO,0,0,0,0,0,0,0,0,0,0,0,0,0,0,0,0,0,0,0,0,0,0,0,0,0,0, ,0,1,0,0
601033807,6,1,33,807,6220,DURAZNO,DURAZNO,0,0,0,0,0,0,0,0,0,0,0,0,0,0,0,0,0,0,0,0,0,0,0,0,0,0, ,0,1,0,0
601033809,6,1,33,809,6220,DURAZNO,DURAZNO,0,0,0,0,0,0,0,0,0,0,0,0,0,0,0,0,0,0,0,0,0,0,0,0,0,0, ,0,1,0,0
601033810,6,1,33,810,6220,DURAZNO,DURAZNO,0,0,0,0,0,0,0,0,0,0,0,0,0,0,0,0,0,0,0,0,0,0,0,0,0,0, ,0,1,0,0
601033814,6,1,33,814,6220,DURAZNO,DURAZNO,0,0,0,0,0,0,0,0,0,0,0,0,0,0,0,0,0,0,0,0,0,0,0,0,0,0, ,0,1,0,0
601126005,6,1,126,5,6220,DURAZNO,DURAZNO,22,21,1,22,21,0,1,0,0,0,21,21,0,0,64,33,31,64,33,31,0,0,0,0,0,0, ,0,1,0,0
601126011,6,1,126,11,6220,DURAZNO,DURAZNO,46,46,0,46,46,0,0,0,0,0,48,48,0,0,172,80,92,172,80,92,0,0,0,0,0,0, ,0,1,0,0
601126012,6,1,126,12,6220,DURAZNO,DURAZNO,37,37,0,37,37,0,0,0,0,0,38,38,0,0,151,71,80,151,71,80,0,0,0,0,0,0, ,0,1,0,0
601126029,6,1,126,29,6220,DURAZNO,DURAZNO,0,0,0,0,0,0,0,0,0,0,0,0,0,0,0,0,0,0,0,0,0,0,0,0,0,0, ,0,1,0,0
601126030,6,1,126,30,6220,DURAZNO,DURAZNO,9,8,1,9,8,0,1,0,0,0,9,9,0,0,35,17,18,35,17,18,0,0,0,0,0,0, ,0,1,0,0
601126031,6,1,126,31,6220,DURAZNO,DURAZNO,14,14,0,14,14,0,0,0,0,0,15,15,0,0,54,22,32,54,22,32,0,0,0,0,0,0, ,0,1,0,0
601126032,6,1,126,32,6220,DURAZNO,DURAZNO,12,11,1,12,11,0,1,0,0,0,11,11,0,0,35,16,19,35,16,19,0,0,0,0,0,0, ,0,1,0,0
601126036,6,1,126,36,6220,DURAZNO,DURAZNO,30,29,1,30,29,0,1,0,0,0,29,29,0,0,122,54,68,122,54,68,0,0,0,0,0,0, ,0,1,0,0
601126039,6,1,126,39,6220,DURAZNO,DURAZNO,17,13,4,17,13,0,4,0,0,0,15,15,0,0,44,23,21,44,23,21,0,0,0,0,0,0, ,0,1,0,0
601126102,6,1,126,102,6220,DURAZNO,DURAZNO,19,18,1,19,18,0,1,0,0,0,18,18,0,0,55,25,30,55,25,30,0,0,0,0,0,0, ,0,1,0,0
601126103,6,1,126,103,6220,DURAZNO,DURAZNO,21,20,1,21,20,0,1,0,0,0,20,20,0,0,70,34,36,70,34,36,0,0,0,0,0,0, ,0,1,0,0
601126202,6,1,126,202,6220,DURAZNO,DURAZNO,20,20,0,20,20,0,0,0,0,0,20,20,0,0,65,34,31,65,34,31,0,0,0,0,0,0, ,0,1,0,0
601126203,6,1,126,203,6220,DURAZNO,DURAZNO,22,22,0,22,22,0,0,0,0,0,22,22,0,0,92,46,46,92,46,46,0,0,0,0,0,0, ,0,1,0,0
601126400,6,1,126,400,6220,DURAZNO,DURAZNO,0,0,0,0,0,0,0,0,0,0,0,0,0,0,0,0,0,0,0,0,0,0,0,0,0,0, ,0,1,0,0
601126401,6,1,126,401,6220,DURAZNO,DURAZNO,0,0,0,0,0,0,0,0,0,0,0,0,0,0,0,0,0,0,0,0,0,0,0,0,0,0, ,0,1,0,0
601126500,6,1,126,500,6220,DURAZNO,DURAZNO,0,0,0,0,0,0,0,0,0,0,0,0,0,0,0,0,0,0,0,0,0,0,0,0,0,0, ,0,1,0,0
601126602,6,1,126,602,6220,DURAZNO,DURAZNO,0,0,0,0,0,0,0,0,0,0,0,0,0,0,0,0,0,0,0,0,0,0,0,0,0,0, ,0,1,0,0
601126603,6,1,126,603,6220,DURAZNO,DURAZNO,2,2,0,2,2,0,0,0,0,0,2,2,0,0,5,3,2,5,3,2,0,0,0,0,0,0, ,0,1,0,0
601126604,6,1,126,604,6220,DURAZNO,DURAZNO,25,19,6,25,19,0,6,0,0,0,19,19,0,0,57,30,27,57,30,27,0,0,0,0,0,0, ,0,1,0,0
601126605,6,1,126,605,6220,DURAZNO,DURAZNO,31,30,1,31,30,0,1,0,0,0,30,30,0,0,150,67,83,150,67,83,0,0,0,0,0,0, ,0,1,0,0
601126606,6,1,126,606,6220,DURAZNO,DURAZNO,11,10,1,11,10,0,1,0,0,0,19,19,0,0,79,43,36,79,43,36,0,0,0,0,0,0, ,0,1,0,0
601126607,6,1,126,607,6220,DURAZNO,DURAZNO,11,8,3,11,8,0,3,0,0,0,9,9,0,0,48,25,23,48,25,23,0,0,0,0,0,0, ,0,1,0,0
601126608,6,1,126,608,6220,DURAZNO,DURAZNO,1,1,0,1,1,0,0,0,0,0,1,1,0,0,4,3,1,4,3,1,0,0,0,0,0,0, ,0,1,0,0
601126609,6,1,126,609,6220,DURAZNO,DURAZNO,18,16,2,18,16,1,2,0,0,0,16,16,1,0,62,35,27,62,35,27,3,2,1,0,0,0, ,0,1,0,0
601126610,6,1,126,610,6220,DURAZNO,DURAZNO,15,15,0,15,15,0,0,0,0,0,15,15,0,0,71,36,35,71,36,35,0,0,0,0,0,0, ,0,1,0,0
601126611,6,1,126,611,6220,DURAZNO,DURAZNO,8,8,0,8,8,0,0,0,0,0,9,9,0,0,41,19,22,41,19,22,0,0,0,0,0,0, ,0,1,0,0
601126700,6,1,126,700,6220,DURAZNO,DURAZNO,37,36,1,37,36,0,1,0,0,0,36,36,0,0,142,72,70,142,72,70,0,0,0,0,0,0, ,0,1,0,0
601126801,6,1,126,801,6220,DURAZNO,DURAZNO,4,2,2,4,2,0,2,0,0,0,2,2,0,0,10,4,6,10,4,6,0,0,0,0,0,0, ,0,1,0,0
601126802,6,1,126,802,6220,DURAZNO,DURAZNO,20,16,4,20,16,0,4,0,0,0,17,17,0,0,81,40,41,81,40,41,0,0,0,0,0,0, ,0,1,0,0
601126804,6,1,126,804,6220,DURAZNO,DURAZNO,19,17,2,19,17,0,2,0,0,0,18,18,0,0,66,34,32,66,34,32,0,0,0,0,0,0, ,0,1,0,0
601126805,6,1,126,805,6220,DURAZNO,DURAZNO,24,19,5,24,19,0,5,0,0,0,24,24,0,0,71,36,35,71,36,35,0,0,0,0,0,0, ,0,1,0,0
601126806,6,1,126,806,6220,DURAZNO,DURAZNO,14,13,1,14,13,0,1,0,0,0,13,13,0,0,55,23,32,55,23,32,0,0,0,0,0,0, ,0,1,0,0
601126807,6,1,126,807,6220,DURAZNO,DURAZNO,14,10,4,14,10,0,4,0,0,0,10,10,0,0,35,14,21,35,14,21,0,0,0,0,0,0, ,0,1,0,0
601126809,6,1,126,809,6220,DURAZNO,DURAZNO,7,6,1,7,6,0,1,0,0,0,6,6,0,0,16,10,6,16,10,6,0,0,0,0,0,0, ,0,1,0,0
601126811,6,1,126,811,6220,DURAZNO,DURAZNO,9,9,0,9,9,0,0,0,0,0,9,9,0,0,47,23,24,47,23,24,0,0,0,0,0,0, ,0,1,0,0
601126812,6,1,126,812,6220,DURAZNO,DURAZNO,3,0,3,3,0,0,3,0,0,0,0,0,0,0,0,0,0,0,0,0,0,0,0,0,0,0, ,0,1,0,0
601130002,6,1,130,2,6220,DURAZNO,DURAZNO,19,19,0,19,19,0,0,0,0,0,19,19,0,0,50,24,26,50,24,26,0,0,0,0,0,0, ,0,1,0,0
601130003,6,1,130,3,6220,DURAZNO,DURAZNO,19,19,0,19,19,0,0,0,0,0,19,19,0,0,69,44,25,69,44,25,0,0,0,0,0,0, ,0,1,0,0
601130004,6,1,130,4,6220,DURAZNO,DURAZNO,21,17,4,21,17,0,4,0,0,0,18,18,0,0,54,27,27,54,27,27,0,0,0,0,0,0, ,0,1,0,0
601130005,6,1,130,5,6220,DURAZNO,DURAZNO,23,18,5,23,18,0,5,0,0,0,19,19,0,0,62,33,29,62,33,29,0,0,0,0,0,0, ,0,1,0,0
601130006,6,1,130,6,6220,DURAZNO,DURAZNO,19,18,1,19,18,0,1,0,0,0,18,18,0,0,43,21,22,43,21,22,0,0,0,0,0,0, ,0,1,0,0
601130007,6,1,130,7,6220,DURAZNO,DURAZNO,0,0,0,0,0,0,0,0,0,0,0,0,0,0,0,0,0,0,0,0,0,0,0,0,0,0, ,0,1,0,0
601130008,6,1,130,8,6220,DURAZNO,DURAZNO,3,3,0,3,3,0,0,0,0,0,3,3,0,0,13,3,10,13,3,10,0,0,0,0,0,0, ,0,1,0,0
601130029,6,1,130,29,6220,DURAZNO,DURAZNO,0,0,0,0,0,0,0,0,0,0,0,0,0,0,0,0,0,0,0,0,0,0,0,0,0,0, ,0,1,0,0
601130030,6,1,130,30,6220,DURAZNO,DURAZNO,16,13,3,16,13,0,3,0,0,0,13,13,0,0,47,21,26,47,21,26,0,0,0,0,0,0, ,0,1,0,0
601130031,6,1,130,31,6220,DURAZNO,DURAZNO,0,0,0,0,0,0,0,0,0,0,0,0,0,0,0,0,0,0,0,0,0,0,0,0,0,0, ,0,1,0,0
601130033,6,1,130,33,6220,DURAZNO,DURAZNO,17,17,0,17,17,0,0,0,0,0,17,17,0,0,60,28,32,60,28,32,0,0,0,0,0,0, ,0,1,0,0
601130034,6,1,130,34,6220,DURAZNO,DURAZNO,34,34,0,34,34,0,0,0,0,0,34,34,0,0,127,68,59,127,68,59,0,0,0,0,0,0, ,0,1,0,0
601130035,6,1,130,35,6220,DURAZNO,DURAZNO,31,27,4,31,27,0,4,0,0,0,27,27,0,0,80,39,41,80,39,41,0,0,0,0,0,0, ,0,1,0,0
601130201,6,1,130,201,6220,DURAZNO,DURAZNO,24,20,4,24,20,0,4,0,0,0,20,20,0,0,59,32,27,59,32,27,0,0,0,0,0,0, ,0,1,0,0
601130301,6,1,130,301,6220,DURAZNO,DURAZNO,37,34,3,37,34,0,3,0,0,0,37,37,0,0,131,60,71,131,60,71,0,0,0,0,0,0, ,0,1,0,0
601130800,6,1,130,800,6220,DURAZNO,DURAZNO,3,1,2,3,1,0,2,0,0,0,2,2,0,0,8,4,4,8,4,4,0,0,0,0,0,0, ,0,1,0,0
601130801,6,1,130,801,6220,DURAZNO,DURAZNO,0,0,0,0,0,0,0,0,0,0,0,0,0,0,0,0,0,0,0,0,0,0,0,0,0,0, ,0,1,0,0
601130802,6,1,130,802,6220,DURAZNO,DURAZNO,3,2,1,3,2,0,1,0,0,0,2,2,0,0,7,3,4,7,3,4,0,0,0,0,0,0, ,0,1,0,0
601130803,6,1,130,803,6220,DURAZNO,DURAZNO,21,12,9,21,12,0,9,0,0,0,13,13,0,0,48,23,25,48,23,25,0,0,0,0,0,0, ,0,1,0,0
601130804,6,1,130,804,6220,DURAZNO,DURAZNO,21,19,2,21,19,0,2,0,0,0,19,19,0,0,60,29,31,60,29,31,0,0,0,0,0,0, ,0,1,0,0
601130805,6,1,130,805,6220,DURAZNO,DURAZNO,6,6,0,5,5,0,0,1,1,0,6,5,0,1,60,25,35,14,5,9,0,0,0,46,20,26, ,0,1,0,0
601130806,6,1,130,806,6220,DURAZNO,DURAZNO,14,9,5,14,9,0,5,0,0,0,9,9,0,0,31,15,16,31,15,16,0,0,0,0,0,0, ,0,1,0,0
601226007,6,1,226,7,6220,DURAZNO,DURAZNO,16,16,0,16,16,0,0,0,0,0,17,17,0,0,58,33,25,58,33,25,0,0,0,0,0,0, ,0,1,0,0
601226008,6,1,226,8,6220,DURAZNO,DURAZNO,4,4,0,4,4,0,0,0,0,0,4,4,0,0,12,4,8,12,4,8,0,0,0,0,0,0, ,0,1,0,0
601226010,6,1,226,10,6220,DURAZNO,DURAZNO,7,6,1,7,6,0,1,0,0,0,6,6,0,0,17,9,8,17,9,8,0,0,0,0,0,0, ,0,1,0,0
601226015,6,1,226,15,6220,DURAZNO,DURAZNO,33,32,1,33,32,0,1,0,0,0,32,32,0,0,108,53,55,108,53,55,0,0,0,0,0,0, ,0,1,0,0
601226016,6,1,226,16,6220,DURAZNO,DURAZNO,27,27,0,27,27,0,0,0,0,0,27,27,0,0,78,40,38,78,40,38,0,0,0,0,0,0, ,0,1,0,0
601226017,6,1,226,17,6220,DURAZNO,DURAZNO,23,23,0,23,23,0,0,0,0,0,24,24,0,0,74,36,38,74,36,38,0,0,0,0,0,0, ,0,1,0,0
601226018,6,1,226,18,6220,DURAZNO,DURAZNO,6,6,0,6,6,0,0,0,0,0,6,6,0,0,17,6,11,17,6,11,0,0,0,0,0,0, ,0,1,0,0
601226019,6,1,226,19,6220,DURAZNO,DURAZNO,24,24,0,24,24,0,0,0,0,0,24,24,0,0,78,39,39,78,39,39,0,0,0,0,0,0, ,0,1,0,0
601226020,6,1,226,20,6220,DURAZNO,DURAZNO,9,9,0,9,9,0,0,0,0,0,9,9,0,0,29,13,16,29,13,16,0,0,0,0,0,0, ,0,1,0,0
601226021,6,1,226,21,6220,DURAZNO,DURAZNO,11,9,2,11,9,0,2,0,0,0,9,9,0,0,25,12,13,25,12,13,0,0,0,0,0,0, ,0,1,0,0
601226022,6,1,226,22,6220,DURAZNO,DURAZNO,23,23,0,23,23,0,0,0,0,0,25,25,0,0,61,31,30,61,31,30,0,0,0,0,0,0, ,0,1,0,0
601226023,6,1,226,23,6220,DURAZNO,DURAZNO,20,20,0,20,20,0,0,0,0,0,20,20,0,0,46,20,26,46,20,26,0,0,0,0,0,0, ,0,1,0,0
601226024,6,1,226,24,6220,DURAZNO,DURAZNO,16,13,3,16,13,0,3,0,0,0,13,13,0,0,47,25,22,47,25,22,0,0,0,0,0,0, ,0,1,0,0
601226025,6,1,226,25,6220,DURAZNO,DURAZNO,11,11,0,11,11,0,0,0,0,0,11,11,0,0,42,24,18,42,24,18,0,0,0,0,0,0, ,0,1,0,0
601226026,6,1,226,26,6220,DURAZNO,DURAZNO,16,14,2,16,14,0,2,0,0,0,14,14,0,0,38,19,19,38,19,19,0,0,0,0,0,0, ,0,1,0,0
601226028,6,1,226,28,6220,DURAZNO,DURAZNO,32,30,2,32,30,0,2,0,0,0,31,31,0,0,91,42,49,91,42,49,0,0,0,0,0,0, ,0,1,0,0
601226037,6,1,226,37,6220,DURAZNO,DURAZNO,27,24,3,27,24,0,3,0,0,0,25,25,0,0,72,39,33,72,39,33,0,0,0,0,0,0, ,0,1,0,0
601226038,6,1,226,38,6220,DURAZNO,DURAZNO,43,38,5,43,38,0,5,0,0,0,38,38,0,0,98,49,49,98,49,49,0,0,0,0,0,0, ,0,1,0,0
601226400,6,1,226,400,6220,DURAZNO,DURAZNO,0,0,0,0,0,0,0,0,0,0,0,0,0,0,0,0,0,0,0,0,0,0,0,0,0,0, ,0,1,0,0
601226401,6,1,226,401,6220,DURAZNO,DURAZNO,0,0,0,0,0,0,0,0,0,0,0,0,0,0,0,0,0,0,0,0,0,0,0,0,0,0, ,0,1,0,0
601226402,6,1,226,402,6220,DURAZNO,DURAZNO,0,0,0,0,0,0,0,0,0,0,0,0,0,0,0,0,0,0,0,0,0,0,0,0,0,0, ,0,1,0,0
601226403,6,1,226,403,6220,DURAZNO,DURAZNO,0,0,0,0,0,0,0,0,0,0,0,0,0,0,0,0,0,0,0,0,0,0,0,0,0,0, ,0,1,0,0
601226404,6,1,226,404,6220,DURAZNO,DURAZNO,0,0,0,0,0,0,0,0,0,0,0,0,0,0,0,0,0,0,0,0,0,0,0,0,0,0, ,0,1,0,0
601226405,6,1,226,405,6220,DURAZNO,DURAZNO,0,0,0,0,0,0,0,0,0,0,0,0,0,0,0,0,0,0,0,0,0,0,0,0,0,0, ,0,1,0,0
601226406,6,1,226,406,6220,DURAZNO,DURAZNO,0,0,0,0,0,0,0,0,0,0,0,0,0,0,0,0,0,0,0,0,0,0,0,0,0,0, ,0,1,0,0
601226407,6,1,226,407,6220,DURAZNO,DURAZNO,0,0,0,0,0,0,0,0,0,0,0,0,0,0,0,0,0,0,0,0,0,0,0,0,0,0, ,0,1,0,0
601226408,6,1,226,408,6220,DURAZNO,DURAZNO,0,0,0,0,0,0,0,0,0,0,0,0,0,0,0,0,0,0,0,0,0,0,0,0,0,0, ,0,1,0,0
601226409,6,1,226,409,6220,DURAZNO,DURAZNO,0,0,0,0,0,0,0,0,0,0,0,0,0,0,0,0,0,0,0,0,0,0,0,0,0,0, ,0,1,0,0
601226410,6,1,226,410,6220,DURAZNO,DURAZNO,0,0,0,0,0,0,0,0,0,0,0,0,0,0,0,0,0,0,0,0,0,0,0,0,0,0, ,0,1,0,0
601226500,6,1,226,500,6220,DURAZNO,DURAZNO,0,0,0,0,0,0,0,0,0,0,0,0,0,0,0,0,0,0,0,0,0,0,0,0,0,0, ,0,1,0,0
601226600,6,1,226,600,6220,DURAZNO,DURAZNO,0,0,0,0,0,0,0,0,0,0,0,0,0,0,0,0,0,0,0,0,0,0,0,0,0,0, ,0,1,0,0
601226602,6,1,226,602,6220,DURAZNO,DURAZNO,3,2,1,2,2,0,0,1,0,1,2,2,0,0,3,1,2,3,1,2,0,0,0,0,0,0, ,0,1,0,0
601226603,6,1,226,603,6220,DURAZNO,DURAZNO,10,9,1,10,9,0,1,0,0,0,9,9,0,0,29,13,16,29,13,16,0,0,0,0,0,0, ,0,1,0,0
601226700,6,1,226,700,6220,DURAZNO,DURAZNO,20,19,1,20,19,0,1,0,0,0,19,19,0,0,25,9,16,25,9,16,0,0,0,0,0,0, ,0,1,0,0
601226800,6,1,226,800,6220,DURAZNO,DURAZNO,17,13,4,16,12,0,4,1,1,0,13,12,0,1,53,18,35,35,17,18,0,0,0,18,1,17, ,0,1,0,0
601230012,6,1,230,12,6220,DURAZNO,DURAZNO,54,52,2,54,52,0,2,0,0,0,52,52,0,0,179,83,96,179,83,96,0,0,0,0,0,0, ,0,1,0,0
601230013,6,1,230,13,6220,DURAZNO,DURAZNO,33,23,10,32,23,0,9,1,0,1,23,23,0,0,82,44,38,82,44,38,0,0,0,0,0,0, ,0,1,0,0
601230014,6,1,230,14,6220,DURAZNO,DURAZNO,12,7,5,12,7,0,5,0,0,0,7,7,0,0,28,15,13,28,15,13,0,0,0,0,0,0, ,0,1,0,0
601230015,6,1,230,15,6220,DURAZNO,DURAZNO,21,18,3,21,18,0,3,0,0,0,18,18,0,0,55,23,32,55,23,32,0,0,0,0,0,0, ,0,1,0,0
601230016,6,1,230,16,6220,DURAZNO,DURAZNO,5,4,1,5,4,0,1,0,0,0,4,4,0,0,20,10,10,20,10,10,0,0,0,0,0,0, ,0,1,0,0
601230017,6,1,230,17,6220,DURAZNO,DURAZNO,32,30,2,32,30,0,2,0,0,0,30,30,0,0,118,61,57,118,61,57,0,0,0,0,0,0, ,0,1,0,0
601230018,6,1,230,18,6220,DURAZNO,DURAZNO,45,38,7,45,38,0,7,0,0,0,39,39,0,0,140,75,65,140,75,65,0,0,0,0,0,0, ,0,1,0,0
601230020,6,1,230,20,6220,DURAZNO,DURAZNO,5,5,0,5,5,0,0,0,0,0,5,5,0,0,16,8,8,16,8,8,0,0,0,0,0,0, ,0,1,0,0
601230021,6,1,230,21,6220,DURAZNO,DURAZNO,9,8,1,9,8,0,1,0,0,0,8,8,0,0,29,17,12,29,17,12,0,0,0,0,0,0, ,0,1,0,0
601230022,6,1,230,22,6220,DURAZNO,DURAZNO,15,14,1,15,14,0,1,0,0,0,14,14,0,0,49,24,25,49,24,25,0,0,0,0,0,0, ,0,1,0,0
601230023,6,1,230,23,6220,DURAZNO,DURAZNO,12,9,3,12,9,0,3,0,0,0,9,9,0,0,24,14,10,24,14,10,0,0,0,0,0,0, ,0,1,0,0
601230024,6,1,230,24,6220,DURAZNO,DURAZNO,7,5,2,7,5,0,2,0,0,0,5,5,0,0,14,7,7,14,7,7,0,0,0,0,0,0, ,0,1,0,0
601230027,6,1,230,27,6220,DURAZNO,DURAZNO,14,13,1,14,13,0,1,0,0,0,13,13,0,0,50,26,24,50,26,24,0,0,0,0,0,0, ,0,1,0,0
601230028,6,1,230,28,6220,DURAZNO,DURAZNO,9,6,3,9,6,0,3,0,0,0,6,6,0,0,24,15,9,24,15,9,0,0,0,0,0,0, ,0,1,0,0
601230036,6,1,230,36,6220,DURAZNO,DURAZNO,14,12,2,14,12,0,2,0,0,0,12,12,0,0,49,22,27,49,22,27,0,0,0,0,0,0, ,0,1,0,0
601230037,6,1,230,37,6220,DURAZNO,DURAZNO,26,26,0,26,26,0,0,0,0,0,29,29,0,0,88,45,43,88,45,43,0,0,0,0,0,0, ,0,1,0,0
601230038,6,1,230,38,6220,DURAZNO,DURAZNO,22,15,7,22,15,0,7,0,0,0,15,15,0,0,48,29,19,48,29,19,0,0,0,0,0,0, ,0,1,0,0
601230039,6,1,230,39,6220,DURAZNO,DURAZNO,34,29,5,34,29,0,5,0,0,0,30,30,0,0,110,62,48,110,62,48,0,0,0,0,0,0, ,0,1,0,0
601230040,6,1,230,40,6220,DURAZNO,DURAZNO,26,22,4,26,22,0,4,0,0,0,22,22,0,0,85,46,39,85,46,39,0,0,0,0,0,0, ,0,1,0,0
601230041,6,1,230,41,6220,DURAZNO,DURAZNO,17,16,1,17,16,0,1,0,0,0,16,16,0,0,64,34,30,64,34,30,0,0,0,0,0,0, ,0,1,0,0
601230043,6,1,230,43,6220,DURAZNO,DURAZNO,14,10,4,14,10,0,4,0,0,0,10,10,0,0,36,22,14,36,22,14,0,0,0,0,0,0, ,0,1,0,0
601230044,6,1,230,44,6220,DURAZNO,DURAZNO,5,3,2,5,3,0,2,0,0,0,3,3,0,0,10,6,4,10,6,4,0,0,0,0,0,0, ,0,1,0,0
601230045,6,1,230,45,6220,DURAZNO,DURAZNO,26,21,5,26,21,0,5,0,0,0,21,21,0,0,73,39,34,73,39,34,0,0,0,0,0,0, ,0,1,0,0
601230046,6,1,230,46,6220,DURAZNO,DURAZNO,18,14,4,18,14,0,4,0,0,0,16,16,0,0,34,20,14,34,20,14,0,0,0,0,0,0, ,0,1,0,0
601230800,6,1,230,800,6220,DURAZNO,DURAZNO,18,16,2,18,16,0,2,0,0,0,16,16,0,0,44,20,24,44,20,24,0,0,0,0,0,0, ,0,1,0,0
601230801,6,1,230,801,6220,DURAZNO,DURAZNO,17,9,8,17,9,0,8,0,0,0,9,9,0,0,30,16,14,30,16,14,0,0,0,0,0,0, ,0,1,0,0
601230802,6,1,230,802,6220,DURAZNO,DURAZNO,15,12,3,15,12,0,3,0,0,0,12,12,0,0,49,25,24,49,25,24,0,0,0,0,0,0, ,0,1,0,0
601230803,6,1,230,803,6220,DURAZNO,DURAZNO,36,34,2,36,34,0,2,0,0,0,34,34,0,0,107,50,57,107,50,57,0,0,0,0,0,0, ,0,1,0,0
601230804,6,1,230,804,6220,DURAZNO,DURAZNO,7,5,2,7,5,0,2,0,0,0,5,5,0,0,20,10,10,20,10,10,0,0,0,0,0,0, ,0,1,0,0
601230805,6,1,230,805,6220,DURAZNO,DURAZNO,27,23,4,27,23,0,4,0,0,0,23,23,0,0,76,35,41,76,35,41,0,0,0,0,0,0, ,0,1,0,0
601230806,6,1,230,806,6220,DURAZNO,DURAZNO,30,29,1,30,29,0,1,0,0,0,29,29,0,0,86,45,41,86,45,41,0,0,0,0,0,0, ,0,1,0,0
601230807,6,1,230,807,6220,DURAZNO,DURAZNO,4,1,3,4,1,0,3,0,0,0,1,1,0,0,4,2,2,4,2,2,0,0,0,0,0,0, ,0,1,0,0
601230808,6,1,230,808,6220,DURAZNO,DURAZNO,15,12,3,15,12,0,3,0,0,0,12,12,0,0,58,29,29,58,29,29,0,0,0,0,0,0, ,0,1,0,0
601234800,6,1,234,800,6220,DURAZNO,DURAZNO,3,3,0,3,3,0,0,0,0,0,3,3,0,0,16,9,7,16,9,7,0,0,0,0,0,0, ,0,15,0,0
601234801,6,1,234,801,6220,DURAZNO,DURAZNO,8,8,0,8,8,0,0,0,0,0,8,8,0,0,34,17,17,34,17,17,0,0,0,0,0,0, ,0,15,0,0
601234802,6,1,234,802,6220,DURAZNO,DURAZNO,9,9,0,9,9,0,0,0,0,0,9,9,0,0,37,21,16,37,21,16,0,0,0,0,0,0, ,0,15,0,0
601234803,6,1,234,803,6220,DURAZNO,DURAZNO,3,3,0,3,3,0,0,0,0,0,3,3,0,0,14,6,8,14,6,8,0,0,0,0,0,0, ,0,15,0,0
601234804,6,1,234,804,6220,DURAZNO,DURAZNO,0,0,0,0,0,0,0,0,0,0,0,0,0,0,0,0,0,0,0,0,0,0,0,0,0,0, ,0,15,0,0
601234805,6,1,234,805,6220,DURAZNO,DURAZNO,1,1,0,1,1,0,0,0,0,0,1,1,0,0,5,2,3,5,2,3,0,0,0,0,0,0, ,0,15,0,0
602002002,6,2,2,2,6724,DURAZNO,SANTA BERNARDINA,6,6,0,6,6,0,0,0,0,0,6,6,0,0,17,12,5,17,12,5,0,0,0,0,0,0, ,0,2,0,0
602002004,6,2,2,4,6724,DURAZNO,SANTA BERNARDINA,18,10,8,18,10,0,8,0,0,0,10,10,0,0,35,17,18,35,17,18,0,0,0,0,0,0, ,0,2,0,0
602002005,6,2,2,5,6724,DURAZNO,SANTA BERNARDINA,0,0,0,0,0,0,0,0,0,0,0,0,0,0,0,0,0,0,0,0,0,0,0,0,0,0, ,0,2,0,0
602002007,6,2,2,7,6724,DURAZNO,SANTA BERNARDINA,1,0,1,1,0,0,1,0,0,0,0,0,0,0,0,0,0,0,0,0,0,0,0,0,0,0, ,0,2,0,0
602002008,6,2,2,8,6724,DURAZNO,SANTA BERNARDINA,5,5,0,5,5,0,0,0,0,0,5,5,0,0,21,11,10,21,11,10,0,0,0,0,0,0, ,0,2,0,0
602002009,6,2,2,9,6724,DURAZNO,SANTA BERNARDINA,3,2,1,3,2,0,1,0,0,0,2,2,0,0,4,0,4,4,0,4,0,0,0,0,0,0, ,0,2,0,0
602002010,6,2,2,10,6724,DURAZNO,SANTA BERNARDINA,20,17,3,20,17,0,3,0,0,0,18,18,0,0,66,33,33,66,33,33,0,0,0,0,0,0, ,0,2,0,0
602002011,6,2,2,11,6724,DURAZNO,SANTA BERNARDINA,0,0,0,0,0,0,0,0,0,0,0,0,0,0,0,0,0,0,0,0,0,0,0,0,0,0, ,0,2,0,0
602002012,6,2,2,12,6724,DURAZNO,SANTA BERNARDINA,0,0,0,0,0,0,0,0,0,0,0,0,0,0,0,0,0,0,0,0,0,0,0,0,0,0, ,0,2,0,0
602002013,6,2,2,13,6724,DURAZNO,SANTA BERNARDINA,0,0,0,0,0,0,0,0,0,0,0,0,0,0,0,0,0,0,0,0,0,0,0,0,0,0, ,0,2,0,0
602002014,6,2,2,14,6724,DURAZNO,SANTA BERNARDINA,0,0,0,0,0,0,0,0,0,0,0,0,0,0,0,0,0,0,0,0,0,0,0,0,0,0, ,0,2,0,0
602002015,6,2,2,15,6724,DURAZNO,SANTA BERNARDINA,4,4,0,4,4,0,0,0,0,0,4,4,0,0,13,7,6,13,7,6,0,0,0,0,0,0, ,0,2,0,0
602002016,6,2,2,16,6724,DURAZNO,SANTA BERNARDINA,2,0,2,2,0,0,2,0,0,0,0,0,0,0,0,0,0,0,0,0,0,0,0,0,0,0, ,0,2,0,0
602002400,6,2,2,400,6724,DURAZNO,SANTA BERNARDINA,0,0,0,0,0,0,0,0,0,0,0,0,0,0,0,0,0,0,0,0,0,0,0,0,0,0, ,0,2,0,0
602002401,6,2,2,401,6724,DURAZNO,SANTA BERNARDINA,0,0,0,0,0,0,0,0,0,0,0,0,0,0,0,0,0,0,0,0,0,0,0,0,0,0, ,0,2,0,0
602002402,6,2,2,402,6724,DURAZNO,SANTA BERNARDINA,0,0,0,0,0,0,0,0,0,0,0,0,0,0,0,0,0,0,0,0,0,0,0,0,0,0, ,0,2,0,0
602002403,6,2,2,403,6724,DURAZNO,SANTA BERNARDINA,0,0,0,0,0,0,0,0,0,0,0,0,0,0,0,0,0,0,0,0,0,0,0,0,0,0, ,0,2,0,0
602002404,6,2,2,404,6724,DURAZNO,SANTA BERNARDINA,0,0,0,0,0,0,0,0,0,0,0,0,0,0,0,0,0,0,0,0,0,0,0,0,0,0, ,0,2,0,0
602002405,6,2,2,405,6724,DURAZNO,SANTA BERNARDINA,0,0,0,0,0,0,0,0,0,0,0,0,0,0,0,0,0,0,0,0,0,0,0,0,0,0, ,0,2,0,0
602002600,6,2,2,600,6724,DURAZNO,SANTA BERNARDINA,41,37,4,41,37,0,4,0,0,0,39,39,0,0,115,59,56,115,59,56,0,0,0,0,0,0, ,0,2,0,0
602002800,6,2,2,800,6724,DURAZNO,SANTA BERNARDINA,0,0,0,0,0,0,0,0,0,0,0,0,0,0,0,0,0,0,0,0,0,0,0,0,0,0, ,0,2,0,0
602002801,6,2,2,801,6724,DURAZNO,SANTA BERNARDINA,12,10,2,12,10,0,2,0,0,0,10,10,0,0,32,15,17,32,15,17,0,0,0,0,0,0, ,0,2,0,0
602002802,6,2,2,802,6724,DURAZNO,SANTA BERNARDINA,2,2,0,2,2,0,0,0,0,0,2,2,0,0,5,3,2,5,3,2,0,0,0,0,0,0, ,0,2,0,0
602002803,6,2,2,803,6724,DURAZNO,SANTA BERNARDINA,9,6,3,9,6,0,3,0,0,0,6,6,0,0,13,9,4,13,9,4,0,0,0,0,0,0, ,0,2,0,0
602002804,6,2,2,804,6724,DURAZNO,SANTA BERNARDINA,32,19,13,32,19,0,13,0,0,0,20,20,0,0,57,24,33,57,24,33,0,0,0,0,0,0, ,0,2,0,0
602002805,6,2,2,805,6724,DURAZNO,SANTA BERNARDINA,1,1,0,1,1,0,0,0,0,0,1,1,0,0,4,2,2,4,2,2,0,0,0,0,0,0, ,0,2,0,0
602002806,6,2,2,806,6724,DURAZNO,SANTA BERNARDINA,0,0,0,0,0,0,0,0,0,0,0,0,0,0,0,0,0,0,0,0,0,0,0,0,0,0, ,0,2,0,0
602101001,6,2,101,1,6724,DURAZNO,SANTA BERNARDINA,16,14,2,16,14,0,2,0,0,0,14,14,0,0,41,24,17,41,24,17,0,0,0,0,0,0, ,0,1,0,0
602101003,6,2,101,3,6724,DURAZNO,SANTA BERNARDINA,2,2,0,2,2,0,0,0,0,0,2,2,0,0,5,2,3,5,2,3,0,0,0,0,0,0, ,0,1,0,0
602101005,6,2,101,5,6724,DURAZNO,SANTA BERNARDINA,0,0,0,0,0,0,0,0,0,0,0,0,0,0,0,0,0,0,0,0,0,0,0,0,0,0, ,0,1,0,0
602101006,6,2,101,6,6724,DURAZNO,SANTA BERNARDINA,0,0,0,0,0,0,0,0,0,0,0,0,0,0,0,0,0,0,0,0,0,0,0,0,0,0, ,0,1,0,0
602101007,6,2,101,7,6724,DURAZNO,SANTA BERNARDINA,13,13,0,12,12,0,0,1,1,0,13,12,0,1,31,15,16,29,13,16,0,0,0,2,2,0, ,0,1,0,0
602101008,6,2,101,8,6724,DURAZNO,SANTA BERNARDINA,13,12,1,13,12,0,1,0,0,0,12,12,0,0,31,16,15,31,16,15,0,0,0,0,0,0, ,0,1,0,0
602101009,6,2,101,9,6724,DURAZNO,SANTA BERNARDINA,20,17,3,20,17,0,3,0,0,0,18,18,0,0,46,23,23,46,23,23,0,0,0,0,0,0, ,0,1,0,0
602101010,6,2,101,10,6724,DURAZNO,SANTA BERNARDINA,17,16,1,17,16,0,1,0,0,0,16,16,0,0,49,22,27,49,22,27,0,0,0,0,0,0, ,0,1,0,0
602101011,6,2,101,11,6724,DURAZNO,SANTA BERNARDINA,22,15,7,22,15,0,7,0,0,0,15,15,0,0,42,18,24,42,18,24,0,0,0,0,0,0, ,0,1,0,0
602101013,6,2,101,13,6724,DURAZNO,SANTA BERNARDINA,23,19,4,23,19,0,4,0,0,0,19,19,0,0,57,29,28,57,29,28,0,0,0,0,0,0, ,0,1,0,0
602101014,6,2,101,14,6724,DURAZNO,SANTA BERNARDINA,20,18,2,20,18,0,2,0,0,0,18,18,0,0,59,31,28,59,31,28,0,0,0,0,0,0, ,0,1,0,0
602101015,6,2,101,15,6724,DURAZNO,SANTA BERNARDINA,18,17,1,18,17,0,1,0,0,0,17,17,0,0,45,16,29,45,16,29,0,0,0,0,0,0, ,0,1,0,0
602101016,6,2,101,16,6724,DURAZNO,SANTA BERNARDINA,14,12,2,14,12,0,2,0,0,0,12,12,0,0,37,19,18,37,19,18,0,0,0,0,0,0, ,0,1,0,0
602101017,6,2,101,17,6724,DURAZNO,SANTA BERNARDINA,8,7,1,8,7,0,1,0,0,0,7,7,0,0,16,7,9,16,7,9,0,0,0,0,0,0, ,0,1,0,0
602101018,6,2,101,18,6724,DURAZNO,SANTA BERNARDINA,13,10,3,13,10,0,3,0,0,0,10,10,0,0,32,16,16,32,16,16,0,0,0,0,0,0, ,0,1,0,0
602101800,6,2,101,800,6724,DURAZNO,SANTA BERNARDINA,1,0,1,1,0,0,1,0,0,0,0,0,0,0,0,0,0,0,0,0,0,0,0,0,0,0, ,0,1,0,0
602101801,6,2,101,801,6724,DURAZNO,SANTA BERNARDINA,10,7,3,10,7,0,3,0,0,0,7,7,0,0,22,11,11,22,11,11,0,0,0,0,0,0, ,0,1,0,0
602201019,6,2,201,19,6724,DURAZNO,SANTA BERNARDINA,6,6,0,6,6,0,0,0,0,0,6,6,0,0,23,11,12,23,11,12,0,0,0,0,0,0, ,0,1,0,0
602201020,6,2,201,20,6724,DURAZNO,SANTA BERNARDINA,11,8,3,11,8,0,3,0,0,0,8,8,0,0,26,16,10,26,16,10,0,0,0,0,0,0, ,0,1,0,0
602201021,6,2,201,21,6724,DURAZNO,SANTA BERNARDINA,0,0,0,0,0,0,0,0,0,0,0,0,0,0,0,0,0,0,0,0,0,0,0,0,0,0, ,0,1,0,0
602201023,6,2,201,23,6724,DURAZNO,SANTA BERNARDINA,5,3,2,5,3,0,2,0,0,0,3,3,0,0,11,6,5,11,6,5,0,0,0,0,0,0, ,0,1,0,0
602201024,6,2,201,24,6724,DURAZNO,SANTA BERNARDINA,5,4,1,5,4,0,1,0,0,0,4,4,0,0,15,7,8,15,7,8,0,0,0,0,0,0, ,0,1,0,0
602201025,6,2,201,25,6724,DURAZNO,SANTA BERNARDINA,5,3,2,5,3,0,2,0,0,0,3,3,0,0,8,5,3,8,5,3,0,0,0,0,0,0, ,0,1,0,0
602201026,6,2,201,26,6724,DURAZNO,SANTA BERNARDINA,5,5,0,5,5,0,0,0,0,0,5,5,0,0,13,6,7,13,6,7,0,0,0,0,0,0, ,0,1,0,0
602201027,6,2,201,27,6724,DURAZNO,SANTA BERNARDINA,0,0,0,0,0,0,0,0,0,0,0,0,0,0,0,0,0,0,0,0,0,0,0,0,0,0, ,0,1,0,0
602201028,6,2,201,28,6724,DURAZNO,SANTA BERNARDINA,3,3,0,3,3,0,0,0,0,0,3,3,0,0,6,3,3,6,3,3,0,0,0,0,0,0, ,0,1,0,0
602201029,6,2,201,29,6724,DURAZNO,SANTA BERNARDINA,3,2,1,3,2,0,1,0,0,0,2,2,0,0,5,2,3,5,2,3,0,0,0,0,0,0, ,0,1,0,0
602201030,6,2,201,30,6724,DURAZNO,SANTA BERNARDINA,1,0,1,1,0,0,1,0,0,0,0,0,0,0,0,0,0,0,0,0,0,0,0,0,0,0, ,0,1,0,0
602201031,6,2,201,31,6724,DURAZNO,SANTA BERNARDINA,3,3,0,3,3,0,0,0,0,0,3,3,0,0,6,3,3,6,3,3,0,0,0,0,0,0, ,0,1,0,0
602201032,6,2,201,32,6724,DURAZNO,SANTA BERNARDINA,4,3,1,4,3,0,1,0,0,0,3,3,0,0,12,7,5,12,7,5,0,0,0,0,0,0, ,0,1,0,0
602201033,6,2,201,33,6724,DURAZNO,SANTA BERNARDINA,1,1,0,1,1,0,0,0,0,0,1,1,0,0,2,1,1,2,1,1,0,0,0,0,0,0, ,0,1,0,0
602201034,6,2,201,34,6724,DURAZNO,SANTA BERNARDINA,0,0,0,0,0,0,0,0,0,0,0,0,0,0,0,0,0,0,0,0,0,0,0,0,0,0, ,0,1,0,0
602201800,6,2,201,800,6724,DURAZNO,SANTA BERNARDINA,0,0,0,0,0,0,0,0,0,0,0,0,0,0,0,0,0,0,0,0,0,0,0,0,0,0, ,0,1,0,0
602201801,6,2,201,801,6724,DURAZNO,SANTA BERNARDINA,7,7,0,7,7,0,0,0,0,0,7,7,0,0,21,11,10,21,11,10,0,0,0,0,0,0, ,0,1,0,0
602201802,6,2,201,802,6724,DURAZNO,SANTA BERNARDINA,3,1,2,3,1,0,2,0,0,0,1,1,0,0,1,0,1,1,0,1,0,0,0,0,0,0, ,0,1,0,0
602201803,6,2,201,803,6724,DURAZNO,SANTA BERNARDINA,17,15,2,17,15,0,2,0,0,0,15,15,0,0,50,25,25,50,25,25,0,0,0,0,0,0, ,0,1,0,0
1201001001,12,1,1,1,12320,RIO NEGRO,FRAY BENTOS,2,2,0,2,2,0,0,0,0,0,2,2,0,0,2,1,1,2,1,1,0,0,0,0,0,0, ,0,2,0,0
1201001002,12,1,1,2,12320,RIO NEGRO,FRAY BENTOS,10,9,1,10,9,0,1,0,0,0,9,9,0,0,28,13,15,28,13,15,0,0,0,0,0,0, ,0,2,0,0
1201001003,12,1,1,3,12320,RIO NEGRO,FRAY BENTOS,1,1,0,1,1,0,0,0,0,0,1,1,0,0,5,3,2,5,3,2,0,0,0,0,0,0, ,0,2,0,0
1201001004,12,1,1,4,12320,RIO NEGRO,FRAY BENTOS,3,2,1,3,2,0,1,0,0,0,2,2,0,0,7,3,4,7,3,4,0,0,0,0,0,0, ,0,2,0,0
1201001006,12,1,1,6,12320,RIO NEGRO,FRAY BENTOS,0,0,0,0,0,0,0,0,0,0,0,0,0,0,0,0,0,0,0,0,0,0,0,0,0,0, ,0,2,0,0
1201001008,12,1,1,8,12320,RIO NEGRO,FRAY BENTOS,10,8,2,10,8,0,2,0,0,0,8,8,0,0,21,13,8,21,13,8,0,0,0,0,0,0, ,0,2,0,0
1201001009,12,1,1,9,12320,RIO NEGRO,FRAY BENTOS,33,26,7,33,26,0,7,0,0,0,27,27,0,0,72,35,37,72,35,37,0,0,0,0,0,0, ,0,2,0,0
1201001010,12,1,1,10,12320,RIO NEGRO,FRAY BENTOS,11,10,1,11,10,0,1,0,0,0,10,10,0,0,31,12,19,31,12,19,0,0,0,0,0,0, ,0,2,0,0
1201001011,12,1,1,11,12320,RIO NEGRO,FRAY BENTOS,0,0,0,0,0,0,0,0,0,0,0,0,0,0,0,0,0,0,0,0,0,0,0,0,0,0, ,0,2,0,0
1201001012,12,1,1,12,12320,RIO NEGRO,FRAY BENTOS,55,50,5,55,50,0,5,0,0,0,50,50,0,0,118,57,61,118,57,61,0,0,0,0,0,0, ,0,2,0,0
1201001013,12,1,1,13,12320,RIO NEGRO,FRAY BENTOS,25,17,8,25,17,0,8,0,0,0,17,17,0,0,49,22,27,49,22,27,0,0,0,0,0,0, ,0,2,0,0
1201001014,12,1,1,14,12320,RIO NEGRO,FRAY BENTOS,20,17,3,20,17,0,3,0,0,0,17,17,0,0,49,17,32,49,17,32,0,0,0,0,0,0, ,0,2,0,0
1201001015,12,1,1,15,12320,RIO NEGRO,FRAY BENTOS,26,18,8,26,18,0,8,0,0,0,18,18,0,0,43,17,26,43,17,26,0,0,0,0,0,0, ,0,2,0,0
1201001016,12,1,1,16,12320,RIO NEGRO,FRAY BENTOS,10,8,2,9,7,0,2,1,1,0,7,7,0,0,23,12,11,23,12,11,0,0,0,0,0,0, ,0,2,0,0
1201001017,12,1,1,17,12320,RIO NEGRO,FRAY BENTOS,27,17,10,27,17,0,10,0,0,0,18,18,0,0,37,17,20,37,17,20,0,0,0,0,0,0, ,0,2,0,0
1201001018,12,1,1,18,12320,RIO NEGRO,FRAY BENTOS,0,0,0,0,0,0,0,0,0,0,0,0,0,0,0,0,0,0,0,0,0,0,0,0,0,0, ,0,2,0,0
1201001400,12,1,1,400,12320,RIO NEGRO,FRAY BENTOS,0,0,0,0,0,0,0,0,0,0,0,0,0,0,0,0,0,0,0,0,0,0,0,0,0,0, ,0,2,0,0
1201001602,12,1,1,602,12320,RIO NEGRO,FRAY BENTOS,0,0,0,0,0,0,0,0,0,0,0,0,0,0,0,0,0,0,0,0,0,0,0,0,0,0, ,0,2,0,0
1201001700,12,1,1,700,12320,RIO NEGRO,FRAY BENTOS,23,19,4,23,19,0,4,0,0,0,19,19,0,0,43,18,25,43,18,25,0,0,0,0,0,0, ,0,2,0,0
1201002001,12,1,2,1,12320,RIO NEGRO,FRAY BENTOS,13,10,3,13,10,0,3,0,0,0,10,10,0,0,33,14,19,33,14,19,0,0,0,0,0,0, ,0,2,0,0
1201002002,12,1,2,2,12320,RIO NEGRO,FRAY BENTOS,10,9,1,10,9,0,1,0,0,0,9,9,0,0,22,11,11,22,11,11,0,0,0,0,0,0, ,0,2,0,0
1201002003,12,1,2,3,12320,RIO NEGRO,FRAY BENTOS,11,8,3,11,8,0,3,0,0,0,8,8,0,0,29,17,12,29,17,12,0,0,0,0,0,0, ,0,2,0,0
1201002004,12,1,2,4,12320,RIO NEGRO,FRAY BENTOS,26,24,2,26,24,0,2,0,0,0,24,24,0,0,70,34,36,70,34,36,0,0,0,0,0,0, ,0,2,0,0
1201002005,12,1,2,5,12320,RIO NEGRO,FRAY BENTOS,41,39,2,41,39,0,2,0,0,0,39,39,0,0,114,55,59,114,55,59,0,0,0,0,0,0, ,0,2,0,0
1201002006,12,1,2,6,12320,RIO NEGRO,FRAY BENTOS,25,23,2,24,22,0,2,1,1,0,23,22,0,1,92,39,53,77,34,43,0,0,0,15,5,10, ,0,2,0,0
1201002007,12,1,2,7,12320,RIO NEGRO,FRAY BENTOS,29,26,3,29,26,0,3,0,0,0,26,26,0,0,63,27,36,63,27,36,0,0,0,0,0,0, ,0,2,0,0
1201002008,12,1,2,8,12320,RIO NEGRO,FRAY BENTOS,23,22,1,23,22,0,1,0,0,0,22,22,0,0,51,22,29,51,22,29,0,0,0,0,0,0, ,0,2,0,0
1201002009,12,1,2,9,12320,RIO NEGRO,FRAY BENTOS,48,44,4,48,44,0,4,0,0,0,44,44,0,0,114,48,66,114,48,66,0,0,0,0,0,0, ,0,2,0,0
1201002010,12,1,2,10,12320,RIO NEGRO,FRAY BENTOS,22,18,4,22,18,0,4,0,0,0,18,18,0,0,55,25,30,55,25,30,0,0,0,0,0,0, ,0,2,0,0
1201002011,12,1,2,11,12320,RIO NEGRO,FRAY BENTOS,27,23,4,27,23,0,4,0,0,0,24,24,0,0,76,40,36,76,40,36,0,0,0,0,0,0, ,0,2,0,0
1201002012,12,1,2,12,12320,RIO NEGRO,FRAY BENTOS,29,27,2,29,27,0,2,0,0,0,27,27,0,0,64,34,30,64,34,30,0,0,0,0,0,0, ,0,2,0,0
1201002013,12,1,2,13,12320,RIO NEGRO,FRAY BENTOS,25,22,3,25,22,0,3,0,0,0,22,22,0,0,53,25,28,53,25,28,0,0,0,0,0,0, ,0,2,0,0
1201002014,12,1,2,14,12320,RIO NEGRO,FRAY BENTOS,28,26,2,28,26,0,2,0,0,0,26,26,0,0,64,29,35,64,29,35,0,0,0,0,0,0, ,0,2,0,0
1201002015,12,1,2,15,12320,RIO NEGRO,FRAY BENTOS,22,22,0,22,22,0,0,0,0,0,24,24,0,0,65,27,38,65,27,38,0,0,0,0,0,0, ,0,2,0,0
1201003001,12,1,3,1,12320,RIO NEGRO,FRAY BENTOS,26,25,1,26,25,0,1,0,0,0,27,27,0,0,85,38,47,85,38,47,0,0,0,0,0,0, ,0,2,0,0
1201003002,12,1,3,2,12320,RIO NEGRO,FRAY BENTOS,17,16,1,17,16,0,1,0,0,0,16,16,0,0,44,20,24,44,20,24,0,0,0,0,0,0, ,0,2,0,0
1201003003,12,1,3,3,12320,RIO NEGRO,FRAY BENTOS,14,14,0,14,14,0,0,0,0,0,14,14,0,0,51,29,22,51,29,22,0,0,0,0,0,0, ,0,2,0,0
1201003004,12,1,3,4,12320,RIO NEGRO,FRAY BENTOS,24,21,3,24,21,0,3,0,0,0,22,22,0,0,58,30,28,58,30,28,0,0,0,0,0,0, ,0,2,0,0
1201003005,12,1,3,5,12320,RIO NEGRO,FRAY BENTOS,19,19,0,18,18,0,0,1,1,0,19,19,0,0,47,24,23,47,24,23,0,0,0,0,0,0, ,0,2,0,0
1201003006,12,1,3,6,12320,RIO NEGRO,FRAY BENTOS,25,23,2,25,23,0,2,0,0,0,23,23,0,0,72,32,40,72,32,40,0,0,0,0,0,0, ,0,2,0,0
1201003007,12,1,3,7,12320,RIO NEGRO,FRAY BENTOS,25,23,2,25,23,0,2,0,0,0,23,23,0,0,72,36,36,72,36,36,0,0,0,0,0,0, ,0,2,0,0
1201003008,12,1,3,8,12320,RIO NEGRO,FRAY BENTOS,0,0,0,0,0,0,0,0,0,0,0,0,0,0,0,0,0,0,0,0,0,0,0,0,0,0, ,0,2,0,0
1201003009,12,1,3,9,12320,RIO NEGRO,FRAY BENTOS,29,23,6,29,23,0,6,0,0,0,25,25,0,0,63,34,29,63,34,29,0,0,0,0,0,0, ,0,2,0,0
1201003010,12,1,3,10,12320,RIO NEGRO,FRAY BENTOS,22,21,1,22,21,0,1,0,0,0,22,22,0,0,62,36,26,62,36,26,0,0,0,0,0,0, ,0,2,0,0
1201003011,12,1,3,11,12320,RIO NEGRO,FRAY BENTOS,17,17,0,16,16,0,0,1,1,0,17,16,0,1,106,39,67,37,16,21,0,0,0,69,23,46, ,0,2,0,0
1201003012,12,1,3,12,12320,RIO NEGRO,FRAY BENTOS,19,17,2,19,17,0,2,0,0,0,17,17,0,0,38,17,21,38,17,21,0,0,0,0,0,0, ,0,2,0,0
1201003013,12,1,3,13,12320,RIO NEGRO,FRAY BENTOS,3,2,1,3,2,0,1,0,0,0,2,2,0,0,12,4,8,12,4,8,0,0,0,0,0,0, ,0,2,0,0
1201004001,12,1,4,1,12320,RIO NEGRO,FRAY BENTOS,12,12,0,12,12,0,0,0,0,0,12,12,0,0,47,22,25,47,22,25,0,0,0,0,0,0, ,0,2,0,0
1201004002,12,1,4,2,12320,RIO NEGRO,FRAY BENTOS,7,7,0,7,7,0,0,0,0,0,7,7,0,0,24,12,12,24,12,12,0,0,0,0,0,0, ,0,2,0,0
1201004003,12,1,4,3,12320,RIO NEGRO,FRAY BENTOS,8,7,1,8,7,0,1,0,0,0,7,7,0,0,19,8,11,19,8,11,0,0,0,0,0,0, ,0,2,0,0
1201004004,12,1,4,4,12320,RIO NEGRO,FRAY BENTOS,33,32,1,33,32,0,1,0,0,0,32,32,0,0,99,49,50,99,49,50,0,0,0,0,0,0, ,0,2,0,0
1201004005,12,1,4,5,12320,RIO NEGRO,FRAY BENTOS,24,24,0,24,24,0,0,0,0,0,26,26,0,0,76,38,38,76,38,38,0,0,0,0,0,0, ,0,2,0,0
1201004006,12,1,4,6,12320,RIO NEGRO,FRAY BENTOS,28,27,1,28,27,0,1,0,0,0,27,27,0,0,90,42,48,90,42,48,0,0,0,0,0,0, ,0,2,0,0
1201004007,12,1,4,7,12320,RIO NEGRO,FRAY BENTOS,28,24,4,28,24,0,4,0,0,0,24,24,0,0,66,32,34,66,32,34,0,0,0,0,0,0, ,0,2,0,0
1201004008,12,1,4,8,12320,RIO NEGRO,FRAY BENTOS,24,21,3,24,21,0,3,0,0,0,21,21,0,0,70,31,39,70,31,39,0,0,0,0,0,0, ,0,2,0,0
1201004009,12,1,4,9,12320,RIO NEGRO,FRAY BENTOS,22,22,0,22,22,0,0,0,0,0,23,23,0,0,75,35,40,75,35,40,0,0,0,0,0,0, ,0,2,0,0
1201004010,12,1,4,10,12320,RIO NEGRO,FRAY BENTOS,22,19,3,22,19,0,3,0,0,0,19,19,0,0,55,25,30,55,25,30,0,0,0,0,0,0, ,0,2,0,0
1201004011,12,1,4,11,12320,RIO NEGRO,FRAY BENTOS,28,26,2,28,26,0,2,0,0,0,26,26,0,0,82,41,41,82,41,41,0,0,0,0,0,0, ,0,2,0,0
1201004012,12,1,4,12,12320,RIO NEGRO,FRAY BENTOS,29,29,0,29,29,0,0,0,0,0,29,29,0,0,82,32,50,82,32,50,0,0,0,0,0,0, ,0,2,0,0
1201005001,12,1,5,1,12320,RIO NEGRO,FRAY BENTOS,15,12,3,15,12,0,3,0,0,0,12,12,0,0,36,16,20,36,16,20,0,0,0,0,0,0, ,0,2,0,0
1201005002,12,1,5,2,12320,RIO NEGRO,FRAY BENTOS,17,17,0,17,17,0,0,0,0,0,17,17,0,0,63,33,30,63,33,30,0,0,0,0,0,0, ,0,2,0,0
1201005004,12,1,5,4,12320,RIO NEGRO,FRAY BENTOS,15,14,1,15,14,0,1,0,0,0,16,16,0,0,61,30,31,61,30,31,0,0,0,0,0,0, ,0,2,0,0
1201005005,12,1,5,5,12320,RIO NEGRO,FRAY BENTOS,13,12,1,13,12,0,1,0,0,0,12,12,0,0,42,22,20,42,22,20,0,0,0,0,0,0, ,0,2,0,0
1201005006,12,1,5,6,12320,RIO NEGRO,FRAY BENTOS,21,21,0,21,21,0,0,0,0,0,21,21,0,0,65,31,34,65,31,34,0,0,0,0,0,0, ,0,2,0,0
1201005007,12,1,5,7,12320,RIO NEGRO,FRAY BENTOS,39,38,1,39,38,0,1,0,0,0,38,38,0,0,139,74,65,139,74,65,0,0,0,0,0,0, ,0,2,0,0
1201005008,12,1,5,8,12320,RIO NEGRO,FRAY BENTOS,16,14,2,16,14,0,2,0,0,0,14,14,0,0,44,17,27,44,17,27,0,0,0,0,0,0, ,0,2,0,0
1201005009,12,1,5,9,12320,RIO NEGRO,FRAY BENTOS,31,29,2,31,29,0,2,0,0,0,30,30,0,0,77,43,34,77,43,34,0,0,0,0,0,0, ,0,2,0,0
1201005010,12,1,5,10,12320,RIO NEGRO,FRAY BENTOS,20,19,1,20,19,0,1,0,0,0,19,19,0,0,60,33,27,60,33,27,0,0,0,0,0,0, ,0,2,0,0
1201005011,12,1,5,11,12320,RIO NEGRO,FRAY BENTOS,29,28,1,29,28,0,1,0,0,0,29,29,0,0,74,31,43,74,31,43,0,0,0,0,0,0, ,0,2,0,0
1201005012,12,1,5,12,12320,RIO NEGRO,FRAY BENTOS,19,19,0,19,19,0,0,0,0,0,20,20,0,0,57,27,30,57,27,30,0,0,0,0,0,0, ,0,2,0,0
1201005013,12,1,5,13,12320,RIO NEGRO,FRAY BENTOS,23,23,0,23,23,0,0,0,0,0,23,23,0,0,80,41,39,80,41,39,0,0,0,0,0,0, ,0,2,0,0
1201005014,12,1,5,14,12320,RIO NEGRO,FRAY BENTOS,28,26,2,28,26,0,2,0,0,0,28,28,0,0,91,38,53,91,38,53,0,0,0,0,0,0, ,0,2,0,0
1201005015,12,1,5,15,12320,RIO NEGRO,FRAY BENTOS,38,34,4,38,34,0,4,0,0,0,35,35,0,0,102,50,52,102,50,52,0,0,0,0,0,0, ,0,2,0,0
1201005016,12,1,5,16,12320,RIO NEGRO,FRAY BENTOS,12,12,0,12,12,0,0,0,0,0,12,12,0,0,44,23,21,44,23,21,0,0,0,0,0,0, ,0,2,0,0
1201005017,12,1,5,17,12320,RIO NEGRO,FRAY BENTOS,15,15,0,15,15,0,0,0,0,0,15,15,0,0,39,24,15,39,24,15,0,0,0,0,0,0, ,0,2,0,0
1201005018,12,1,5,18,12320,RIO NEGRO,FRAY BENTOS,12,10,2,12,10,0,2,0,0,0,10,10,0,0,29,15,14,29,15,14,0,0,0,0,0,0, ,0,2,0,0
1201005800,12,1,5,800,12320,RIO NEGRO,FRAY BENTOS,13,13,0,13,13,0,0,0,0,0,13,13,0,0,30,14,16,30,14,16,0,0,0,0,0,0, ,0,2,0,0
1201005801,12,1,5,801,12320,RIO NEGRO,FRAY BENTOS,2,2,0,2,2,0,0,0,0,0,2,2,0,0,7,2,5,7,2,5,0,0,0,0,0,0, ,0,2,0,0
1201006001,12,1,6,1,12320,RIO NEGRO,FRAY BENTOS,8,8,0,8,8,0,0,0,0,0,8,8,0,0,24,14,10,24,14,10,0,0,0,0,0,0, ,0,2,0,0
1201006002,12,1,6,2,12320,RIO NEGRO,FRAY BENTOS,26,24,2,26,24,0,2,0,0,0,25,25,0,0,72,36,36,72,36,36,0,0,0,0,0,0, ,0,2,0,0
1201006003,12,1,6,3,12320,RIO NEGRO,FRAY BENTOS,41,36,5,41,36,0,5,0,0,0,36,36,0,0,63,28,35,63,28,35,0,0,0,0,0,0, ,0,2,0,0
1201006004,12,1,6,4,12320,RIO NEGRO,FRAY BENTOS,15,15,0,15,15,0,0,0,0,0,16,16,0,0,39,23,16,39,23,16,0,0,0,0,0,0, ,0,2,0,0
1201006005,12,1,6,5,12320,RIO NEGRO,FRAY BENTOS,13,12,1,13,12,0,1,0,0,0,12,12,0,0,42,25,17,42,25,17,0,0,0,0,0,0, ,0,2,0,0
1201006006,12,1,6,6,12320,RIO NEGRO,FRAY BENTOS,32,31,1,32,31,0,1,0,0,0,31,31,0,0,94,41,53,94,41,53,0,0,0,0,0,0, ,0,2,0,0
1201006007,12,1,6,7,12320,RIO NEGRO,FRAY BENTOS,25,21,4,25,21,0,4,0,0,0,22,22,0,0,61,32,29,61,32,29,0,0,0,0,0,0, ,0,2,0,0
1201006008,12,1,6,8,12320,RIO NEGRO,FRAY BENTOS,20,19,1,20,19,0,1,0,0,0,19,19,0,0,59,29,30,59,29,30,0,0,0,0,0,0, ,0,2,0,0
1201006009,12,1,6,9,12320,RIO NEGRO,FRAY BENTOS,30,29,1,30,29,0,1,0,0,0,29,29,0,0,92,39,53,92,39,53,0,0,0,0,0,0, ,0,2,0,0
1201006010,12,1,6,10,12320,RIO NEGRO,FRAY BENTOS,14,14,0,14,14,0,0,0,0,0,14,14,0,0,40,18,22,40,18,22,0,0,0,0,0,0, ,0,2,0,0
1201006011,12,1,6,11,12320,RIO NEGRO,FRAY BENTOS,32,30,2,32,30,0,2,0,0,0,31,31,0,0,90,42,48,90,42,48,0,0,0,0,0,0, ,0,2,0,0
1201006012,12,1,6,12,12320,RIO NEGRO,FRAY BENTOS,28,25,3,28,25,0,3,0,0,0,26,26,0,0,91,47,44,91,47,44,0,0,0,0,0,0, ,0,2,0,0
1201006013,12,1,6,13,12320,RIO NEGRO,FRAY BENTOS,30,28,2,30,28,0,2,0,0,0,28,28,0,0,77,39,38,77,39,38,0,0,0,0,0,0, ,0,2,0,0
1201007001,12,1,7,1,12320,RIO NEGRO,FRAY BENTOS,27,26,1,27,26,0,1,0,0,0,26,26,0,0,60,32,28,60,32,28,0,0,0,0,0,0, ,0,2,0,0
1201007002,12,1,7,2,12320,RIO NEGRO,FRAY BENTOS,22,22,0,22,22,0,0,0,0,0,24,24,0,0,75,38,37,75,38,37,0,0,0,0,0,0, ,0,2,0,0
1201007003,12,1,7,3,12320,RIO NEGRO,FRAY BENTOS,26,21,5,26,21,0,5,0,0,0,22,22,0,0,68,29,39,68,29,39,0,0,0,0,0,0, ,0,2,0,0
1201007004,12,1,7,4,12320,RIO NEGRO,FRAY BENTOS,22,20,2,22,20,0,2,0,0,0,20,20,0,0,53,30,23,53,30,23,0,0,0,0,0,0, ,0,2,0,0
1201007005,12,1,7,5,12320,RIO NEGRO,FRAY BENTOS,26,25,1,26,25,0,1,0,0,0,36,36,0,0,117,59,58,117,59,58,0,0,0,0,0,0, ,0,2,0,0
1201007006,12,1,7,6,12320,RIO NEGRO,FRAY BENTOS,13,8,5,13,8,0,5,0,0,0,8,8,0,0,23,11,12,23,11,12,0,0,0,0,0,0, ,0,2,0,0
1201007007,12,1,7,7,12320,RIO NEGRO,FRAY BENTOS,23,18,5,23,18,0,5,0,0,0,18,18,0,0,50,26,24,50,26,24,0,0,0,0,0,0, ,0,2,0,0
1201007008,12,1,7,8,12320,RIO NEGRO,FRAY BENTOS,20,18,2,20,18,0,2,0,0,0,18,18,0,0,54,27,27,54,27,27,0,0,0,0,0,0, ,0,2,0,0
1201007009,12,1,7,9,12320,RIO NEGRO,FRAY BENTOS,21,20,1,21,20,0,1,0,0,0,21,21,0,0,56,29,27,56,29,27,0,0,0,0,0,0, ,0,2,0,0
1201007010,12,1,7,10,12320,RIO NEGRO,FRAY BENTOS,15,13,2,15,13,0,2,0,0,0,13,13,0,0,28,8,20,28,8,20,0,0,0,0,0,0, ,0,2,0,0
1201007011,12,1,7,11,12320,RIO NEGRO,FRAY BENTOS,18,14,4,18,14,0,4,0,0,0,14,14,0,0,44,25,19,44,25,19,0,0,0,0,0,0, ,0,2,0,0
1201007012,12,1,7,12,12320,RIO NEGRO,FRAY BENTOS,18,17,1,18,17,0,1,0,0,0,18,18,0,0,52,23,29,52,23,29,0,0,0,0,0,0, ,0,2,0,0
1201007013,12,1,7,13,12320,RIO NEGRO,FRAY BENTOS,20,18,2,20,18,0,2,0,0,0,19,19,0,0,52,24,28,52,24,28,0,0,0,0,0,0, ,0,2,0,0
1201007014,12,1,7,14,12320,RIO NEGRO,FRAY BENTOS,34,28,6,34,28,0,6,0,0,0,28,28,0,0,73,32,41,73,32,41,0,0,0,0,0,0, ,0,2,0,0
1201007015,12,1,7,15,12320,RIO NEGRO,FRAY BENTOS,24,24,0,24,24,0,0,0,0,0,24,24,0,0,71,33,38,71,33,38,0,0,0,0,0,0, ,0,2,0,0
1201008001,12,1,8,1,12320,RIO NEGRO,FRAY BENTOS,31,27,4,31,27,0,4,0,0,0,27,27,0,0,66,36,30,66,36,30,0,0,0,0,0,0, ,0,2,0,0
1201008002,12,1,8,2,12320,RIO NEGRO,FRAY BENTOS,26,24,2,26,24,0,2,0,0,0,24,24,0,0,59,24,35,59,24,35,0,0,0,0,0,0, ,0,2,0,0
1201008003,12,1,8,3,12320,RIO NEGRO,FRAY BENTOS,18,18,0,18,18,0,0,0,0,0,18,18,0,0,70,36,34,70,36,34,0,0,0,0,0,0, ,0,2,0,0
1201008004,12,1,8,4,12320,RIO NEGRO,FRAY BENTOS,19,19,0,19,19,0,0,0,0,0,19,19,0,0,45,18,27,45,18,27,0,0,0,0,0,0, ,0,2,0,0
1201008005,12,1,8,5,12320,RIO NEGRO,FRAY BENTOS,19,16,3,19,16,0,3,0,0,0,16,16,0,0,43,17,26,43,17,26,0,0,0,0,0,0, ,0,2,0,0
1201008006,12,1,8,6,12320,RIO NEGRO,FRAY BENTOS,15,13,2,15,13,0,2,0,0,0,13,13,0,0,49,22,27,49,22,27,0,0,0,0,0,0, ,0,2,0,0
1201008007,12,1,8,7,12320,RIO NEGRO,FRAY BENTOS,28,27,1,28,27,0,1,0,0,0,28,28,0,0,77,39,38,77,39,38,0,0,0,0,0,0, ,0,2,0,0
1201008008,12,1,8,8,12320,RIO NEGRO,FRAY BENTOS,22,22,0,22,22,0,0,0,0,0,22,22,0,0,55,29,26,55,29,26,0,0,0,0,0,0, ,0,2,0,0
1201008009,12,1,8,9,12320,RIO NEGRO,FRAY BENTOS,0,0,0,0,0,0,0,0,0,0,0,0,0,0,0,0,0,0,0,0,0,0,0,0,0,0, ,0,2,0,0
1201008010,12,1,8,10,12320,RIO NEGRO,FRAY BENTOS,30,29,1,30,29,0,1,0,0,0,31,31,0,0,85,43,42,85,43,42,0,0,0,0,0,0, ,0,2,0,0
1201008011,12,1,8,11,12320,RIO NEGRO,FRAY BENTOS,23,21,2,23,21,0,2,0,0,0,21,21,0,0,62,28,34,62,28,34,0,0,0,0,0,0, ,0,2,0,0
1201008012,12,1,8,12,12320,RIO NEGRO,FRAY BENTOS,13,12,1,13,12,0,1,0,0,0,13,13,0,0,45,19,26,45,19,26,0,0,0,0,0,0, ,0,2,0,0
1201008013,12,1,8,13,12320,RIO NEGRO,FRAY BENTOS,12,12,0,12,12,0,0,0,0,0,12,12,0,0,24,9,15,24,9,15,0,0,0,0,0,0, ,0,2,0,0
1201008014,12,1,8,14,12320,RIO NEGRO,FRAY BENTOS,20,17,3,20,17,0,3,0,0,0,17,17,0,0,41,20,21,41,20,21,0,0,0,0,0,0, ,0,2,0,0
1201008015,12,1,8,15,12320,RIO NEGRO,FRAY BENTOS,30,27,3,30,27,0,3,0,0,0,27,27,0,0,83,36,47,83,36,47,0,0,0,0,0,0, ,0,2,0,0
1201008016,12,1,8,16,12320,RIO NEGRO,FRAY BENTOS,26,24,2,26,24,0,2,0,0,0,24,24,0,0,59,31,28,59,31,28,0,0,0,0,0,0, ,0,2,0,0
1201009001,12,1,9,1,12320,RIO NEGRO,FRAY BENTOS,0,0,0,0,0,0,0,0,0,0,0,0,0,0,0,0,0,0,0,0,0,0,0,0,0,0, ,0,2,0,0
1201009002,12,1,9,2,12320,RIO NEGRO,FRAY BENTOS,25,24,1,25,24,0,1,0,0,0,28,28,0,0,65,30,35,65,30,35,0,0,0,0,0,0, ,0,2,0,0
1201009003,12,1,9,3,12320,RIO NEGRO,FRAY BENTOS,26,23,3,26,23,0,3,0,0,0,23,23,0,0,68,36,32,68,36,32,0,0,0,0,0,0, ,0,2,0,0
1201009004,12,1,9,4,12320,RIO NEGRO,FRAY BENTOS,18,17,1,18,17,0,1,0,0,0,18,18,0,0,61,28,33,61,28,33,0,0,0,0,0,0, ,0,2,0,0
1201009005,12,1,9,5,12320,RIO NEGRO,FRAY BENTOS,8,7,1,8,7,0,1,0,0,0,7,7,0,0,18,10,8,18,10,8,0,0,0,0,0,0, ,0,2,0,0
1201009006,12,1,9,6,12320,RIO NEGRO,FRAY BENTOS,17,17,0,17,17,0,0,0,0,0,17,17,0,0,48,23,25,48,23,25,0,0,0,0,0,0, ,0,2,0,0
1201009007,12,1,9,7,12320,RIO NEGRO,FRAY BENTOS,27,26,1,27,26,0,1,0,0,0,27,27,0,0,64,33,31,64,33,31,0,0,0,0,0,0, ,0,2,0,0
1201009008,12,1,9,8,12320,RIO NEGRO,FRAY BENTOS,22,20,2,22,20,0,2,0,0,0,21,21,0,0,65,29,36,65,29,36,0,0,0,0,0,0, ,0,2,0,0
1201009009,12,1,9,9,12320,RIO NEGRO,FRAY BENTOS,18,16,2,18,16,0,2,0,0,0,16,16,0,0,36,14,22,36,14,22,0,0,0,0,0,0, ,0,2,0,0
1201009010,12,1,9,10,12320,RIO NEGRO,FRAY BENTOS,25,22,3,25,22,0,3,0,0,0,23,23,0,0,50,20,30,50,20,30,0,0,0,0,0,0, ,0,2,0,0
1201009011,12,1,9,11,12320,RIO NEGRO,FRAY BENTOS,26,21,5,26,21,0,5,0,0,0,21,21,0,0,46,18,28,46,18,28,0,0,0,0,0,0, ,0,2,0,0
1201009012,12,1,9,12,12320,RIO NEGRO,FRAY BENTOS,0,0,0,0,0,0,0,0,0,0,0,0,0,0,0,0,0,0,0,0,0,0,0,0,0,0, ,0,2,0,0
1201009013,12,1,9,13,12320,RIO NEGRO,FRAY BENTOS,15,13,2,15,13,0,2,0,0,0,13,13,0,0,41,24,17,41,24,17,0,0,0,0,0,0, ,0,2,0,0
1201009015,12,1,9,15,12320,RIO NEGRO,FRAY BENTOS,24,21,3,24,21,0,3,0,0,0,21,21,0,0,47,24,23,47,24,23,0,0,0,0,0,0, ,0,2,0,0
1201009016,12,1,9,16,12320,RIO NEGRO,FRAY BENTOS,23,23,0,23,23,0,0,0,0,0,26,26,0,0,61,27,34,61,27,34,0,0,0,0,0,0, ,0,2,0,0
1201009017,12,1,9,17,12320,RIO NEGRO,FRAY BENTOS,24,23,1,24,23,0,1,0,0,0,24,24,0,0,54,25,29,54,25,29,0,0,0,0,0,0, ,0,2,0,0
1201009018,12,1,9,18,12320,RIO NEGRO,FRAY BENTOS,5,4,1,5,4,0,1,0,0,0,4,4,0,0,13,6,7,13,6,7,0,0,0,0,0,0, ,0,2,0,0
1201010001,12,1,10,1,12320,RIO NEGRO,FRAY BENTOS,41,39,2,41,39,0,2,0,0,0,39,39,0,0,121,57,64,121,57,64,0,0,0,0,0,0, ,0,2,0,0
1201010002,12,1,10,2,12320,RIO NEGRO,FRAY BENTOS,22,20,2,22,20,0,2,0,0,0,20,20,0,0,49,24,25,49,24,25,0,0,0,0,0,0, ,0,2,0,0
1201010003,12,1,10,3,12320,RIO NEGRO,FRAY BENTOS,0,0,0,0,0,0,0,0,0,0,0,0,0,0,0,0,0,0,0,0,0,0,0,0,0,0, ,0,2,0,0
1201010004,12,1,10,4,12320,RIO NEGRO,FRAY BENTOS,9,5,4,9,5,0,4,0,0,0,5,5,0,0,9,5,4,9,5,4,0,0,0,0,0,0, ,0,2,0,0
1201010005,12,1,10,5,12320,RIO NEGRO,FRAY BENTOS,27,23,4,27,23,0,4,0,0,0,23,23,0,0,60,27,33,60,27,33,0,0,0,0,0,0, ,0,2,0,0
1201010006,12,1,10,6,12320,RIO NEGRO,FRAY BENTOS,29,23,6,29,23,0,6,0,0,0,23,23,0,0,58,27,31,58,27,31,0,0,0,0,0,0, ,0,2,0,0
1201010007,12,1,10,7,12320,RIO NEGRO,FRAY BENTOS,19,14,5,19,14,0,5,0,0,0,14,14,0,0,36,18,18,36,18,18,0,0,0,0,0,0, ,0,2,0,0
1201010008,12,1,10,8,12320,RIO NEGRO,FRAY BENTOS,24,19,5,24,19,0,5,0,0,0,19,19,0,0,39,17,22,39,17,22,0,0,0,0,0,0, ,0,2,0,0
1201010009,12,1,10,9,12320,RIO NEGRO,FRAY BENTOS,3,0,3,3,0,0,3,0,0,0,0,0,0,0,0,0,0,0,0,0,0,0,0,0,0,0, ,0,2,0,0
1201010010,12,1,10,10,12320,RIO NEGRO,FRAY BENTOS,19,16,3,19,16,0,3,0,0,0,16,16,0,0,46,20,26,46,20,26,0,0,0,0,0,0, ,0,2,0,0
1201010011,12,1,10,11,12320,RIO NEGRO,FRAY BENTOS,22,18,4,22,18,0,4,0,0,0,18,18,0,0,47,20,27,47,20,27,0,0,0,0,0,0, ,0,2,0,0
1201010012,12,1,10,12,12320,RIO NEGRO,FRAY BENTOS,27,23,4,27,23,0,4,0,0,0,25,25,0,0,52,24,28,52,24,28,0,0,0,0,0,0, ,0,2,0,0
1201010013,12,1,10,13,12320,RIO NEGRO,FRAY BENTOS,23,20,3,22,19,0,3,1,1,0,20,19,0,1,58,28,30,49,21,28,0,0,0,9,7,2, ,0,2,0,0
1201010014,12,1,10,14,12320,RIO NEGRO,FRAY BENTOS,20,19,1,20,19,0,1,0,0,0,26,26,0,0,63,34,29,63,34,29,0,0,0,0,0,0, ,0,2,0,0
1201010015,12,1,10,15,12320,RIO NEGRO,FRAY BENTOS,25,24,1,25,24,0,1,0,0,0,24,24,0,0,54,24,30,54,24,30,0,0,0,0,0,0, ,0,2,0,0
1201011001,12,1,11,1,12320,RIO NEGRO,FRAY BENTOS,11,10,1,11,10,0,1,0,0,0,10,10,0,0,22,11,11,22,11,11,0,0,0,0,0,0, ,0,2,0,0
1201011002,12,1,11,2,12320,RIO NEGRO,FRAY BENTOS,32,30,2,32,30,0,2,0,0,0,30,30,0,0,75,39,36,75,39,36,0,0,0,0,0,0, ,0,2,0,0
1201011003,12,1,11,3,12320,RIO NEGRO,FRAY BENTOS,39,34,5,39,34,0,5,0,0,0,34,34,0,0,80,35,45,80,35,45,0,0,0,0,0,0, ,0,2,0,0
1201011004,12,1,11,4,12320,RIO NEGRO,FRAY BENTOS,26,25,1,26,25,0,1,0,0,0,25,25,0,0,69,33,36,69,33,36,0,0,0,0,0,0, ,0,2,0,0
1201011005,12,1,11,5,12320,RIO NEGRO,FRAY BENTOS,16,16,0,16,16,0,0,0,0,0,16,16,0,0,56,26,30,56,26,30,0,0,0,0,0,0, ,0,2,0,0
1201011006,12,1,11,6,12320,RIO NEGRO,FRAY BENTOS,25,23,2,25,23,0,2,0,0,0,23,23,0,0,49,23,26,49,23,26,0,0,0,0,0,0, ,0,2,0,0
1201011007,12,1,11,7,12320,RIO NEGRO,FRAY BENTOS,20,16,4,20,16,0,4,0,0,0,18,18,0,0,51,23,28,51,23,28,0,0,0,0,0,0, ,0,2,0,0
1201011008,12,1,11,8,12320,RIO NEGRO,FRAY BENTOS,21,12,9,21,12,0,9,0,0,0,12,12,0,0,33,13,20,33,13,20,0,0,0,0,0,0, ,0,2,0,0
1201011009,12,1,11,9,12320,RIO NEGRO,FRAY BENTOS,12,8,4,12,8,0,4,0,0,0,8,8,0,0,22,12,10,22,12,10,0,0,0,0,0,0, ,0,2,0,0
1201011010,12,1,11,10,12320,RIO NEGRO,FRAY BENTOS,20,19,1,20,19,0,1,0,0,0,19,19,0,0,47,23,24,47,23,24,0,0,0,0,0,0, ,0,2,0,0
1201011011,12,1,11,11,12320,RIO NEGRO,FRAY BENTOS,17,12,5,17,12,0,5,0,0,0,12,12,0,0,31,13,18,31,13,18,0,0,0,0,0,0, ,0,2,0,0
1201011012,12,1,11,12,12320,RIO NEGRO,FRAY BENTOS,14,10,4,14,10,0,4,0,0,0,10,10,0,0,26,13,13,26,13,13,0,0,0,0,0,0, ,0,2,0,0
1201011013,12,1,11,13,12320,RIO NEGRO,FRAY BENTOS,29,26,3,29,26,0,3,0,0,0,26,26,0,0,76,36,40,76,36,40,0,0,0,0,0,0, ,0,2,0,0
1201011014,12,1,11,14,12320,RIO NEGRO,FRAY BENTOS,19,18,1,19,18,0,1,0,0,0,18,18,0,0,39,18,21,39,18,21,0,0,0,0,0,0, ,0,2,0,0
1201011015,12,1,11,15,12320,RIO NEGRO,FRAY BENTOS,22,17,5,22,17,0,5,0,0,0,17,17,0,0,51,29,22,51,29,22,0,0,0,0,0,0, ,0,2,0,0
1201011016,12,1,11,16,12320,RIO NEGRO,FRAY BENTOS,38,33,5,38,33,0,5,0,0,0,33,33,0,0,71,34,37,71,34,37,0,0,0,0,0,0, ,0,2,0,0
1201012001,12,1,12,1,12320,RIO NEGRO,FRAY BENTOS,12,8,4,12,8,0,4,0,0,0,8,8,0,0,18,9,9,18,9,9,0,0,0,0,0,0, ,0,2,0,0
1201012002,12,1,12,2,12320,RIO NEGRO,FRAY BENTOS,26,19,7,26,19,0,7,0,0,0,19,19,0,0,50,24,26,50,24,26,0,0,0,0,0,0, ,0,2,0,0
1201012003,12,1,12,3,12320,RIO NEGRO,FRAY BENTOS,15,14,1,15,14,0,1,0,0,0,15,15,0,0,35,17,18,35,17,18,0,0,0,0,0,0, ,0,2,0,0
1201012004,12,1,12,4,12320,RIO NEGRO,FRAY BENTOS,26,20,6,26,20,0,6,0,0,0,20,20,0,0,44,20,24,44,20,24,0,0,0,0,0,0, ,0,2,0,0
1201012005,12,1,12,5,12320,RIO NEGRO,FRAY BENTOS,11,9,2,11,9,0,2,0,0,0,16,16,0,0,26,14,12,26,14,12,0,0,0,0,0,0, ,0,2,0,0
1201012006,12,1,12,6,12320,RIO NEGRO,FRAY BENTOS,15,12,3,15,12,0,3,0,0,0,14,14,0,0,35,14,21,35,14,21,0,0,0,0,0,0, ,0,2,0,0
1201012007,12,1,12,7,12320,RIO NEGRO,FRAY BENTOS,17,11,6,17,11,0,6,0,0,0,12,12,0,0,25,9,16,25,9,16,0,0,0,0,0,0, ,0,2,0,0
1201012008,12,1,12,8,12320,RIO NEGRO,FRAY BENTOS,9,8,1,9,8,0,1,0,0,0,8,8,0,0,17,7,10,17,7,10,0,0,0,0,0,0, ,0,2,0,0
1201012009,12,1,12,9,12320,RIO NEGRO,FRAY BENTOS,19,16,3,19,16,0,3,0,0,0,16,16,0,0,47,26,21,47,26,21,0,0,0,0,0,0, ,0,2,0,0
1201012010,12,1,12,10,12320,RIO NEGRO,FRAY BENTOS,20,16,4,20,16,0,4,0,0,0,16,16,0,0,45,19,26,45,19,26,0,0,0,0,0,0, ,0,2,0,0
1201012011,12,1,12,11,12320,RIO NEGRO,FRAY BENTOS,20,13,7,20,13,0,7,0,0,0,13,13,0,0,26,10,16,26,10,16,0,0,0,0,0,0, ,0,2,0,0
1201012012,12,1,12,12,12320,RIO NEGRO,FRAY BENTOS,0,0,0,0,0,0,0,0,0,0,0,0,0,0,0,0,0,0,0,0,0,0,0,0,0,0, ,0,2,0,0
1201012013,12,1,12,13,12320,RIO NEGRO,FRAY BENTOS,20,18,2,20,18,0,2,0,0,0,18,18,0,0,46,22,24,46,22,24,0,0,0,0,0,0, ,0,2,0,0
1201012014,12,1,12,14,12320,RIO NEGRO,FRAY BENTOS,26,19,7,26,19,0,7,0,0,0,19,19,0,0,44,22,22,44,22,22,0,0,0,0,0,0, ,0,2,0,0
1201012015,12,1,12,15,12320,RIO NEGRO,FRAY BENTOS,24,24,0,24,24,0,0,0,0,0,25,25,0,0,67,28,39,67,28,39,0,0,0,0,0,0, ,0,2,0,0
1201012016,12,1,12,16,12320,RIO NEGRO,FRAY BENTOS,31,28,3,31,28,0,3,0,0,0,29,29,0,0,59,25,34,59,25,34,0,0,0,0,0,0, ,0,2,0,0
1201012400,12,1,12,400,12320,RIO NEGRO,FRAY BENTOS,0,0,0,0,0,0,0,0,0,0,0,0,0,0,0,0,0,0,0,0,0,0,0,0,0,0, ,0,2,0,0
1201012401,12,1,12,401,12320,RIO NEGRO,FRAY BENTOS,0,0,0,0,0,0,0,0,0,0,0,0,0,0,0,0,0,0,0,0,0,0,0,0,0,0, ,0,2,0,0
1201012402,12,1,12,402,12320,RIO NEGRO,FRAY BENTOS,0,0,0,0,0,0,0,0,0,0,0,0,0,0,0,0,0,0,0,0,0,0,0,0,0,0, ,0,2,0,0
1201012403,12,1,12,403,12320,RIO NEGRO,FRAY BENTOS,0,0,0,0,0,0,0,0,0,0,0,0,0,0,0,0,0,0,0,0,0,0,0,0,0,0, ,0,2,0,0
1201012404,12,1,12,404,12320,RIO NEGRO,FRAY BENTOS,0,0,0,0,0,0,0,0,0,0,0,0,0,0,0,0,0,0,0,0,0,0,0,0,0,0, ,0,2,0,0
1201012405,12,1,12,405,12320,RIO NEGRO,FRAY BENTOS,0,0,0,0,0,0,0,0,0,0,0,0,0,0,0,0,0,0,0,0,0,0,0,0,0,0, ,0,2,0,0
1201012500,12,1,12,500,12320,RIO NEGRO,FRAY BENTOS,0,0,0,0,0,0,0,0,0,0,0,0,0,0,0,0,0,0,0,0,0,0,0,0,0,0, ,0,2,0,0
1201012501,12,1,12,501,12320,RIO NEGRO,FRAY BENTOS,0,0,0,0,0,0,0,0,0,0,0,0,0,0,0,0,0,0,0,0,0,0,0,0,0,0, ,0,2,0,0
1201013002,12,1,13,2,12320,RIO NEGRO,FRAY BENTOS,25,23,2,25,23,0,2,0,0,0,24,24,0,0,60,26,34,60,26,34,0,0,0,0,0,0, ,0,2,0,0
1201013003,12,1,13,3,12320,RIO NEGRO,FRAY BENTOS,18,14,4,18,14,0,4,0,0,0,16,16,0,0,40,14,26,40,14,26,0,0,0,0,0,0, ,0,2,0,0
1201013004,12,1,13,4,12320,RIO NEGRO,FRAY BENTOS,23,18,5,22,17,0,5,1,1,0,19,18,0,1,56,29,27,46,19,27,0,0,0,10,10,0, ,0,2,0,0
1201013005,12,1,13,5,12320,RIO NEGRO,FRAY BENTOS,21,19,2,21,19,0,2,0,0,0,19,19,0,0,47,17,30,47,17,30,0,0,0,0,0,0, ,0,2,0,0
1201013006,12,1,13,6,12320,RIO NEGRO,FRAY BENTOS,21,20,1,21,20,0,1,0,0,0,21,21,0,0,53,24,29,53,24,29,0,0,0,0,0,0, ,0,2,0,0
1201013007,12,1,13,7,12320,RIO NEGRO,FRAY BENTOS,26,24,2,26,24,0,2,0,0,0,25,25,0,0,68,32,36,68,32,36,0,0,0,0,0,0, ,0,2,0,0
1201013008,12,1,13,8,12320,RIO NEGRO,FRAY BENTOS,28,26,2,28,26,0,2,0,0,0,26,26,0,0,74,34,40,74,34,40,0,0,0,0,0,0, ,0,2,0,0
1201013009,12,1,13,9,12320,RIO NEGRO,FRAY BENTOS,20,16,4,20,16,0,4,0,0,0,16,16,0,0,34,13,21,34,13,21,0,0,0,0,0,0, ,0,2,0,0
1201013010,12,1,13,10,12320,RIO NEGRO,FRAY BENTOS,12,9,3,12,9,0,3,0,0,0,9,9,0,0,24,14,10,24,14,10,0,0,0,0,0,0, ,0,2,0,0
1201013011,12,1,13,11,12320,RIO NEGRO,FRAY BENTOS,25,24,1,25,24,0,1,0,0,0,24,24,0,0,55,24,31,55,24,31,0,0,0,0,0,0, ,0,2,0,0
1201013012,12,1,13,12,12320,RIO NEGRO,FRAY BENTOS,24,20,4,24,20,0,4,0,0,0,21,21,0,0,46,19,27,46,19,27,0,0,0,0,0,0, ,0,2,0,0
1201013013,12,1,13,13,12320,RIO NEGRO,FRAY BENTOS,28,25,3,28,25,0,3,0,0,0,25,25,0,0,64,29,35,64,29,35,0,0,0,0,0,0, ,0,2,0,0
1201013014,12,1,13,14,12320,RIO NEGRO,FRAY BENTOS,1,1,0,1,1,0,0,0,0,0,1,1,0,0,1,1,0,1,1,0,0,0,0,0,0,0, ,0,2,0,0
1201013015,12,1,13,15,12320,RIO NEGRO,FRAY BENTOS,36,29,7,36,29,0,7,0,0,0,29,29,0,0,73,35,38,73,35,38,0,0,0,0,0,0, ,0,2,0,0
1201013016,12,1,13,16,12320,RIO NEGRO,FRAY BENTOS,1,1,0,1,1,0,0,0,0,0,1,1,0,0,3,2,1,3,2,1,0,0,0,0,0,0, ,0,2,0,0
1201013017,12,1,13,17,12320,RIO NEGRO,FRAY BENTOS,1,1,0,1,1,0,0,0,0,0,1,1,0,0,4,3,1,4,3,1,0,0,0,0,0,0, ,0,2,0,0
1201013018,12,1,13,18,12320,RIO NEGRO,FRAY BENTOS,0,0,0,0,0,0,0,0,0,0,0,0,0,0,0,0,0,0,0,0,0,0,0,0,0,0, ,0,2,0,0
1201013400,12,1,13,400,12320,RIO NEGRO,FRAY BENTOS,0,0,0,0,0,0,0,0,0,0,0,0,0,0,0,0,0,0,0,0,0,0,0,0,0,0, ,0,2,0,0
1201013401,12,1,13,401,12320,RIO NEGRO,FRAY BENTOS,0,0,0,0,0,0,0,0,0,0,0,0,0,0,0,0,0,0,0,0,0,0,0,0,0,0, ,0,2,0,0
1201013402,12,1,13,402,12320,RIO NEGRO,FRAY BENTOS,0,0,0,0,0,0,0,0,0,0,0,0,0,0,0,0,0,0,0,0,0,0,0,0,0,0, ,0,2,0,0
1201013600,12,1,13,600,12320,RIO NEGRO,FRAY BENTOS,3,3,0,3,3,0,0,0,0,0,3,3,0,0,9,4,5,9,4,5,0,0,0,0,0,0, ,0,2,0,0
1201013601,12,1,13,601,12320,RIO NEGRO,FRAY BENTOS,0,0,0,0,0,0,0,0,0,0,0,0,0,0,0,0,0,0,0,0,0,0,0,0,0,0, ,0,2,0,0
1201014001,12,1,14,1,12320,RIO NEGRO,FRAY BENTOS,29,26,3,29,26,0,3,0,0,0,28,28,0,0,67,33,34,67,33,34,0,0,0,0,0,0, ,0,2,0,0
1201014002,12,1,14,2,12320,RIO NEGRO,FRAY BENTOS,32,31,1,32,31,0,1,0,0,0,31,31,0,0,74,36,38,74,36,38,0,0,0,0,0,0, ,0,2,0,0
1201014003,12,1,14,3,12320,RIO NEGRO,FRAY BENTOS,24,23,1,24,23,0,1,0,0,0,23,23,0,0,58,27,31,58,27,31,0,0,0,0,0,0, ,0,2,0,0
1201014004,12,1,14,4,12320,RIO NEGRO,FRAY BENTOS,26,22,4,26,22,0,4,0,0,0,24,24,0,0,63,31,32,63,31,32,0,0,0,0,0,0, ,0,2,0,0
1201014005,12,1,14,5,12320,RIO NEGRO,FRAY BENTOS,24,22,2,24,22,0,2,0,0,0,22,22,0,0,55,29,26,55,29,26,0,0,0,0,0,0, ,0,2,0,0
1201014006,12,1,14,6,12320,RIO NEGRO,FRAY BENTOS,21,17,4,21,17,0,4,0,0,0,17,17,0,0,42,20,22,42,20,22,0,0,0,0,0,0, ,0,2,0,0
1201014007,12,1,14,7,12320,RIO NEGRO,FRAY BENTOS,20,19,1,20,19,0,1,0,0,0,19,19,0,0,70,38,32,70,38,32,0,0,0,0,0,0, ,0,2,0,0
1201014008,12,1,14,8,12320,RIO NEGRO,FRAY BENTOS,21,21,0,21,21,0,0,0,0,0,23,23,0,0,65,32,33,65,32,33,0,0,0,0,0,0, ,0,2,0,0
1201014009,12,1,14,9,12320,RIO NEGRO,FRAY BENTOS,25,25,0,25,25,0,0,0,0,0,25,25,0,0,62,29,33,62,29,33,0,0,0,0,0,0, ,0,2,0,0
1201014010,12,1,14,10,12320,RIO NEGRO,FRAY BENTOS,31,28,3,30,28,0,2,1,0,1,29,29,0,0,74,34,40,74,34,40,0,0,0,0,0,0, ,0,2,0,0
1201014011,12,1,14,11,12320,RIO NEGRO,FRAY BENTOS,18,16,2,18,16,0,2,0,0,0,16,16,0,0,39,17,22,39,17,22,0,0,0,0,0,0, ,0,2,0,0
1201014012,12,1,14,12,12320,RIO NEGRO,FRAY BENTOS,16,13,3,16,13,0,3,0,0,0,14,14,0,0,39,20,19,39,20,19,0,0,0,0,0,0, ,0,2,0,0
1201014013,12,1,14,13,12320,RIO NEGRO,FRAY BENTOS,8,8,0,8,8,0,0,0,0,0,9,9,0,0,17,11,6,17,11,6,0,0,0,0,0,0, ,0,2,0,0
1201014014,12,1,14,14,12320,RIO NEGRO,FRAY BENTOS,8,8,0,8,8,0,0,0,0,0,9,9,0,0,25,9,16,25,9,16,0,0,0,0,0,0, ,0,2,0,0
1201014015,12,1,14,15,12320,RIO NEGRO,FRAY BENTOS,13,11,2,13,11,0,2,0,0,0,11,11,0,0,33,15,18,33,15,18,0,0,0,0,0,0, ,0,2,0,0
1201015001,12,1,15,1,12320,RIO NEGRO,FRAY BENTOS,23,21,2,23,21,0,2,0,0,0,21,21,0,0,62,29,33,62,29,33,0,0,0,0,0,0, ,0,2,0,0
1201015002,12,1,15,2,12320,RIO NEGRO,FRAY BENTOS,77,72,5,77,72,1,5,0,0,0,72,72,1,0,193,87,106,193,87,106,2,1,1,0,0,0, ,0,2,0,0
1201015003,12,1,15,3,12320,RIO NEGRO,FRAY BENTOS,23,22,1,23,22,0,1,0,0,0,22,22,0,0,74,37,37,74,37,37,0,0,0,0,0,0, ,0,2,0,0
1201015004,12,1,15,4,12320,RIO NEGRO,FRAY BENTOS,27,24,3,27,24,0,3,0,0,0,24,24,0,0,74,31,43,74,31,43,0,0,0,0,0,0, ,0,2,0,0
1201015005,12,1,15,5,12320,RIO NEGRO,FRAY BENTOS,32,30,2,32,30,0,2,0,0,0,30,30,0,0,94,50,44,94,50,44,0,0,0,0,0,0, ,0,2,0,0
1201015006,12,1,15,6,12320,RIO NEGRO,FRAY BENTOS,28,27,1,28,27,0,1,0,0,0,28,28,0,0,86,39,47,86,39,47,0,0,0,0,0,0, ,0,2,0,0
1201015007,12,1,15,7,12320,RIO NEGRO,FRAY BENTOS,26,25,1,26,25,0,1,0,0,0,27,27,0,0,93,44,49,93,44,49,0,0,0,0,0,0, ,0,2,0,0
1201015008,12,1,15,8,12320,RIO NEGRO,FRAY BENTOS,18,17,1,18,17,0,1,0,0,0,19,19,0,0,56,30,26,56,30,26,0,0,0,0,0,0, ,0,2,0,0
1201015009,12,1,15,9,12320,RIO NEGRO,FRAY BENTOS,52,47,5,52,47,0,5,0,0,0,50,50,0,0,159,74,85,159,74,85,0,0,0,0,0,0, ,0,2,0,0
1201015010,12,1,15,10,12320,RIO NEGRO,FRAY BENTOS,35,27,8,35,27,0,8,0,0,0,27,27,0,0,75,35,40,75,35,40,0,0,0,0,0,0, ,0,2,0,0
1201015011,12,1,15,11,12320,RIO NEGRO,FRAY BENTOS,12,11,1,12,11,0,1,0,0,0,11,11,0,0,35,16,19,35,16,19,0,0,0,0,0,0, ,0,2,0,0
1201015012,12,1,15,12,12320,RIO NEGRO,FRAY BENTOS,13,12,1,13,12,0,1,0,0,0,13,13,0,0,38,20,18,38,20,18,0,0,0,0,0,0, ,0,2,0,0
1201015013,12,1,15,13,12320,RIO NEGRO,FRAY BENTOS,12,12,0,12,12,0,0,0,0,0,12,12,0,0,38,15,23,38,15,23,0,0,0,0,0,0, ,0,2,0,0
1201016001,12,1,16,1,12320,RIO NEGRO,FRAY BENTOS,22,22,0,22,22,0,0,0,0,0,22,22,0,0,54,31,23,54,31,23,0,0,0,0,0,0, ,0,2,0,0
1201016002,12,1,16,2,12320,RIO NEGRO,FRAY BENTOS,25,24,1,25,24,0,1,0,0,0,25,25,0,0,70,32,38,70,32,38,0,0,0,0,0,0, ,0,2,0,0
1201016003,12,1,16,3,12320,RIO NEGRO,FRAY BENTOS,31,30,1,31,30,0,1,0,0,0,31,31,0,0,92,48,44,92,48,44,0,0,0,0,0,0, ,0,2,0,0
1201016004,12,1,16,4,12320,RIO NEGRO,FRAY BENTOS,18,16,2,18,16,0,2,0,0,0,16,16,0,0,47,23,24,47,23,24,0,0,0,0,0,0, ,0,2,0,0
1201016005,12,1,16,5,12320,RIO NEGRO,FRAY BENTOS,24,21,3,24,21,0,3,0,0,0,21,21,0,0,59,24,35,59,24,35,0,0,0,0,0,0, ,0,2,0,0
1201016006,12,1,16,6,12320,RIO NEGRO,FRAY BENTOS,25,21,4,25,21,0,4,0,0,0,24,24,0,0,65,38,27,65,38,27,0,0,0,0,0,0, ,0,2,0,0
1201016007,12,1,16,7,12320,RIO NEGRO,FRAY BENTOS,35,28,7,35,28,0,7,0,0,0,28,28,0,0,89,45,44,89,45,44,0,0,0,0,0,0, ,0,2,0,0
1201016008,12,1,16,8,12320,RIO NEGRO,FRAY BENTOS,21,19,2,21,19,0,2,0,0,0,20,20,0,0,69,32,37,69,32,37,0,0,0,0,0,0, ,0,2,0,0
1201016009,12,1,16,9,12320,RIO NEGRO,FRAY BENTOS,22,21,1,22,21,0,1,0,0,0,21,21,0,0,69,35,34,69,35,34,0,0,0,0,0,0, ,0,2,0,0
1201016010,12,1,16,10,12320,RIO NEGRO,FRAY BENTOS,34,30,4,34,30,0,4,0,0,0,30,30,0,0,94,51,43,94,51,43,0,0,0,0,0,0, ,0,2,0,0
1201016011,12,1,16,11,12320,RIO NEGRO,FRAY BENTOS,55,53,2,55,53,0,2,0,0,0,53,53,0,0,191,97,94,191,97,94,0,0,0,0,0,0, ,0,2,0,0
1201016012,12,1,16,12,12320,RIO NEGRO,FRAY BENTOS,49,47,2,49,47,0,2,0,0,0,48,48,0,0,138,65,73,138,65,73,0,0,0,0,0,0, ,0,2,0,0
1201016014,12,1,16,14,12320,RIO NEGRO,FRAY BENTOS,6,6,0,6,6,0,0,0,0,0,6,6,0,0,16,9,7,16,9,7,0,0,0,0,0,0, ,0,2,0,0
1201016017,12,1,16,17,12320,RIO NEGRO,FRAY BENTOS,37,35,2,37,35,0,2,0,0,0,36,36,0,0,113,52,61,113,52,61,0,0,0,0,0,0, ,0,2,0,0
1201016018,12,1,16,18,12320,RIO NEGRO,FRAY BENTOS,34,28,6,34,28,0,6,0,0,0,28,28,0,0,100,48,52,100,48,52,0,0,0,0,0,0, ,0,2,0,0
1201016400,12,1,16,400,12320,RIO NEGRO,FRAY BENTOS,0,0,0,0,0,0,0,0,0,0,0,0,0,0,0,0,0,0,0,0,0,0,0,0,0,0, ,0,2,0,0
1201016600,12,1,16,600,12320,RIO NEGRO,FRAY BENTOS,15,12,3,15,12,0,3,0,0,0,12,12,0,0,33,16,17,33,16,17,0,0,0,0,0,0, ,0,2,0,0
1201016601,12,1,16,601,12320,RIO NEGRO,FRAY BENTOS,0,0,0,0,0,0,0,0,0,0,0,0,0,0,0,0,0,0,0,0,0,0,0,0,0,0, ,0,2,0,0
1201016602,12,1,16,602,12320,RIO NEGRO,FRAY BENTOS,16,12,4,16,12,0,4,0,0,0,12,12,0,0,25,14,11,25,14,11,0,0,0,0,0,0, ,0,2,0,0
1201016603,12,1,16,603,12320,RIO NEGRO,FRAY BENTOS,8,5,3,8,5,0,3,0,0,0,5,5,0,0,15,9,6,15,9,6,0,0,0,0,0,0, ,0,2,0,0
1201016604,12,1,16,604,12320,RIO NEGRO,FRAY BENTOS,9,7,2,9,7,0,2,0,0,0,7,7,0,0,22,12,10,22,12,10,0,0,0,0,0,0, ,0,2,0,0
1201016605,12,1,16,605,12320,RIO NEGRO,FRAY BENTOS,24,19,5,24,19,0,5,0,0,0,19,19,0,0,47,26,21,47,26,21,0,0,0,0,0,0, ,0,2,0,0
1201016606,12,1,16,606,12320,RIO NEGRO,FRAY BENTOS,15,12,3,15,12,0,3,0,0,0,13,13,0,0,42,21,21,42,21,21,0,0,0,0,0,0, ,0,2,0,0
1201016607,12,1,16,607,12320,RIO NEGRO,FRAY BENTOS,3,3,0,3,3,0,0,0,0,0,3,3,0,0,16,5,11,16,5,11,0,0,0,0,0,0, ,0,2,0,0
1201016608,12,1,16,608,12320,RIO NEGRO,FRAY BENTOS,6,5,1,6,5,0,1,0,0,0,5,5,0,0,17,6,11,17,6,11,0,0,0,0,0,0, ,0,2,0,0
1201016609,12,1,16,609,12320,RIO NEGRO,FRAY BENTOS,6,5,1,6,5,0,1,0,0,0,5,5,0,0,13,8,5,13,8,5,0,0,0,0,0,0, ,0,2,0,0
1201017002,12,1,17,2,12320,RIO NEGRO,FRAY BENTOS,66,62,4,66,62,0,4,0,0,0,63,63,0,0,226,114,112,226,114,112,0,0,0,0,0,0, ,0,2,0,0
1201017003,12,1,17,3,12320,RIO NEGRO,FRAY BENTOS,40,35,5,40,35,0,5,0,0,0,36,36,0,0,115,58,57,115,58,57,0,0,0,0,0,0, ,0,2,0,0
1201017004,12,1,17,4,12320,RIO NEGRO,FRAY BENTOS,6,5,1,6,5,0,1,0,0,0,7,7,0,0,24,14,10,24,14,10,0,0,0,0,0,0, ,0,2,0,0
1201017006,12,1,17,6,12320,RIO NEGRO,FRAY BENTOS,25,24,1,25,24,0,1,0,0,0,24,24,0,0,71,38,33,71,38,33,0,0,0,0,0,0, ,0,2,0,0
1201017007,12,1,17,7,12320,RIO NEGRO,FRAY BENTOS,21,18,3,21,18,0,3,0,0,0,18,18,0,0,63,32,31,63,32,31,0,0,0,0,0,0, ,0,2,0,0
1201017008,12,1,17,8,12320,RIO NEGRO,FRAY BENTOS,22,22,0,22,22,0,0,0,0,0,23,23,0,0,84,45,39,84,45,39,0,0,0,0,0,0, ,0,2,0,0
1201017009,12,1,17,9,12320,RIO NEGRO,FRAY BENTOS,25,24,1,25,24,0,1,0,0,0,24,24,0,0,94,42,52,94,42,52,0,0,0,0,0,0, ,0,2,0,0
1201017010,12,1,17,10,12320,RIO NEGRO,FRAY BENTOS,35,29,6,35,29,0,6,0,0,0,29,29,0,0,113,59,54,113,59,54,0,0,0,0,0,0, ,0,2,0,0
1201017011,12,1,17,11,12320,RIO NEGRO,FRAY BENTOS,18,18,0,18,18,0,0,0,0,0,19,19,0,0,61,32,29,61,32,29,0,0,0,0,0,0, ,0,2,0,0
1201017014,12,1,17,14,12320,RIO NEGRO,FRAY BENTOS,17,14,3,17,14,0,3,0,0,0,14,14,0,0,32,17,15,32,17,15,0,0,0,0,0,0, ,0,2,0,0
1201017015,12,1,17,15,12320,RIO NEGRO,FRAY BENTOS,16,15,1,16,15,0,1,0,0,0,15,15,0,0,43,20,23,43,20,23,0,0,0,0,0,0, ,0,2,0,0
1201017016,12,1,17,16,12320,RIO NEGRO,FRAY BENTOS,16,13,3,16,13,0,3,0,0,0,13,13,0,0,37,24,13,37,24,13,0,0,0,0,0,0, ,0,2,0,0
1201017017,12,1,17,17,12320,RIO NEGRO,FRAY BENTOS,16,16,0,16,16,0,0,0,0,0,16,16,0,0,57,23,34,57,23,34,0,0,0,0,0,0, ,0,2,0,0
1201017018,12,1,17,18,12320,RIO NEGRO,FRAY BENTOS,16,14,2,16,14,0,2,0,0,0,14,14,0,0,39,23,16,39,23,16,0,0,0,0,0,0, ,0,2,0,0
1201017019,12,1,17,19,12320,RIO NEGRO,FRAY BENTOS,16,16,0,16,16,0,0,0,0,0,16,16,0,0,60,29,31,60,29,31,0,0,0,0,0,0, ,0,2,0,0
1201017020,12,1,17,20,12320,RIO NEGRO,FRAY BENTOS,16,16,0,16,16,0,0,0,0,0,16,16,0,0,65,31,34,65,31,34,0,0,0,0,0,0, ,0,2,0,0
1201017021,12,1,17,21,12320,RIO NEGRO,FRAY BENTOS,16,16,0,16,16,0,0,0,0,0,16,16,0,0,55,26,29,55,26,29,0,0,0,0,0,0, ,0,2,0,0
1201017400,12,1,17,400,12320,RIO NEGRO,FRAY BENTOS,0,0,0,0,0,0,0,0,0,0,0,0,0,0,0,0,0,0,0,0,0,0,0,0,0,0, ,0,2,0,0
1201017401,12,1,17,401,12320,RIO NEGRO,FRAY BENTOS,0,0,0,0,0,0,0,0,0,0,0,0,0,0,0,0,0,0,0,0,0,0,0,0,0,0, ,0,2,0,0
1201017600,12,1,17,600,12320,RIO NEGRO,FRAY BENTOS,4,0,4,4,0,0,4,0,0,0,0,0,0,0,0,0,0,0,0,0,0,0,0,0,0,0, ,0,2,0,0
1201017601,12,1,17,601,12320,RIO NEGRO,FRAY BENTOS,16,16,0,16,16,0,0,0,0,0,16,16,0,0,46,21,25,46,21,25,0,0,0,0,0,0, ,0,2,0,0
1201017700,12,1,17,700,12320,RIO NEGRO,FRAY BENTOS,44,38,6,44,38,0,6,0,0,0,38,38,0,0,119,60,59,119,60,59,0,0,0,0,0,0, ,0,2,0,0
1201017701,12,1,17,701,12320,RIO NEGRO,FRAY BENTOS,30,28,2,30,28,0,2,0,0,0,28,28,0,0,100,46,54,100,46,54,0,0,0,0,0,0, ,0,2,0,0
1201019001,12,1,19,1,12320,RIO NEGRO,FRAY BENTOS,9,9,0,9,9,0,0,0,0,0,10,10,0,0,34,23,11,34,23,11,0,0,0,0,0,0, ,0,2,0,0
1201019002,12,1,19,2,12320,RIO NEGRO,FRAY BENTOS,8,8,0,8,8,0,0,0,0,0,8,8,0,0,37,16,21,37,16,21,0,0,0,0,0,0, ,0,2,0,0
1201019003,12,1,19,3,12320,RIO NEGRO,FRAY BENTOS,4,4,0,4,4,0,0,0,0,0,4,4,0,0,18,8,10,18,8,10,0,0,0,0,0,0, ,0,2,0,0
1201019004,12,1,19,4,12320,RIO NEGRO,FRAY BENTOS,14,12,2,14,12,0,2,0,0,0,14,14,0,0,48,20,28,48,20,28,0,0,0,0,0,0, ,0,2,0,0
1201019005,12,1,19,5,12320,RIO NEGRO,FRAY BENTOS,18,17,1,18,17,0,1,0,0,0,17,17,0,0,67,32,35,67,32,35,0,0,0,0,0,0, ,0,2,0,0
1201019006,12,1,19,6,12320,RIO NEGRO,FRAY BENTOS,11,10,1,11,10,0,1,0,0,0,10,10,0,0,38,21,17,38,21,17,0,0,0,0,0,0, ,0,2,0,0
1201019007,12,1,19,7,12320,RIO NEGRO,FRAY BENTOS,22,21,1,22,21,0,1,0,0,0,21,21,0,0,56,28,28,56,28,28,0,0,0,0,0,0, ,0,2,0,0
1201019008,12,1,19,8,12320,RIO NEGRO,FRAY BENTOS,20,20,0,20,20,0,0,0,0,0,20,20,0,0,76,36,40,76,36,40,0,0,0,0,0,0, ,0,2,0,0
1201019009,12,1,19,9,12320,RIO NEGRO,FRAY BENTOS,19,17,2,19,17,0,2,0,0,0,17,17,0,0,56,28,28,56,28,28,0,0,0,0,0,0, ,0,2,0,0
1201019010,12,1,19,10,12320,RIO NEGRO,FRAY BENTOS,14,14,0,14,14,0,0,0,0,0,14,14,0,0,57,27,30,57,27,30,0,0,0,0,0,0, ,0,2,0,0
1201019011,12,1,19,11,12320,RIO NEGRO,FRAY BENTOS,0,0,0,0,0,0,0,0,0,0,0,0,0,0,0,0,0,0,0,0,0,0,0,0,0,0, ,0,2,0,0
1201019012,12,1,19,12,12320,RIO NEGRO,FRAY BENTOS,8,7,1,8,7,0,1,0,0,0,7,7,0,0,21,14,7,21,14,7,0,0,0,0,0,0, ,0,2,0,0
1201019014,12,1,19,14,12320,RIO NEGRO,FRAY BENTOS,10,7,3,10,7,0,3,0,0,0,7,7,0,0,26,12,14,26,12,14,0,0,0,0,0,0, ,0,2,0,0
1201019015,12,1,19,15,12320,RIO NEGRO,FRAY BENTOS,28,22,6,28,22,0,6,0,0,0,23,23,0,0,83,46,37,83,46,37,0,0,0,0,0,0, ,0,2,0,0
1201019016,12,1,19,16,12320,RIO NEGRO,FRAY BENTOS,8,5,3,8,5,0,3,0,0,0,5,5,0,0,18,13,5,18,13,5,0,0,0,0,0,0, ,0,2,0,0
1201019017,12,1,19,17,12320,RIO NEGRO,FRAY BENTOS,14,11,3,14,11,0,3,0,0,0,12,12,0,0,41,26,15,41,26,15,0,0,0,0,0,0, ,0,2,0,0
1201019018,12,1,19,18,12320,RIO NEGRO,FRAY BENTOS,21,18,3,21,18,0,3,0,0,0,20,20,0,0,72,37,35,72,37,35,0,0,0,0,0,0, ,0,2,0,0
1201019019,12,1,19,19,12320,RIO NEGRO,FRAY BENTOS,17,16,1,17,16,0,1,0,0,0,16,16,0,0,67,35,32,67,35,32,0,0,0,0,0,0, ,0,2,0,0
1201019020,12,1,19,20,12320,RIO NEGRO,FRAY BENTOS,4,4,0,4,4,0,0,0,0,0,4,4,0,0,22,12,10,22,12,10,0,0,0,0,0,0, ,0,2,0,0
1201019021,12,1,19,21,12320,RIO NEGRO,FRAY BENTOS,6,6,0,6,6,0,0,0,0,0,7,7,0,0,35,15,20,35,15,20,0,0,0,0,0,0, ,0,2,0,0
1201019022,12,1,19,22,12320,RIO NEGRO,FRAY BENTOS,0,0,0,0,0,0,0,0,0,0,0,0,0,0,0,0,0,0,0,0,0,0,0,0,0,0, ,0,2,0,0
1201019023,12,1,19,23,12320,RIO NEGRO,FRAY BENTOS,9,9,0,9,9,0,0,0,0,0,9,9,0,0,25,12,13,25,12,13,0,0,0,0,0,0, ,0,2,0,0
1201019024,12,1,19,24,12320,RIO NEGRO,FRAY BENTOS,15,12,3,15,12,0,3,0,0,0,13,13,0,0,46,23,23,46,23,23,0,0,0,0,0,0, ,0,2,0,0
1201019025,12,1,19,25,12320,RIO NEGRO,FRAY BENTOS,2,2,0,2,2,0,0,0,0,0,2,2,0,0,13,6,7,13,6,7,0,0,0,0,0,0, ,0,2,0,0
1201019031,12,1,19,31,12320,RIO NEGRO,FRAY BENTOS,13,13,0,13,13,0,0,0,0,0,13,13,0,0,41,21,20,41,21,20,0,0,0,0,0,0, ,0,2,0,0
1201019113,12,1,19,113,12320,RIO NEGRO,FRAY BENTOS,13,12,1,13,12,0,1,0,0,0,12,12,0,0,42,18,24,42,18,24,0,0,0,0,0,0, ,0,2,0,0
1201019213,12,1,19,213,12320,RIO NEGRO,FRAY BENTOS,19,19,0,19,19,0,0,0,0,0,20,20,0,0,67,28,39,67,28,39,0,0,0,0,0,0, ,0,2,0,0
1201020001,12,1,20,1,12320,RIO NEGRO,FRAY BENTOS,16,14,2,16,14,0,2,0,0,0,14,14,0,0,43,25,18,43,25,18,0,0,0,0,0,0, ,0,2,0,0
1201020002,12,1,20,2,12320,RIO NEGRO,FRAY BENTOS,10,10,0,10,10,0,0,0,0,0,11,11,0,0,52,31,21,52,31,21,0,0,0,0,0,0, ,0,2,0,0
1201020003,12,1,20,3,12320,RIO NEGRO,FRAY BENTOS,16,15,1,16,15,0,1,0,0,0,15,15,0,0,52,24,28,52,24,28,0,0,0,0,0,0, ,0,2,0,0
1201020005,12,1,20,5,12320,RIO NEGRO,FRAY BENTOS,22,20,2,22,20,0,2,0,0,0,21,21,0,0,77,46,31,77,46,31,0,0,0,0,0,0, ,0,2,0,0
1201020006,12,1,20,6,12320,RIO NEGRO,FRAY BENTOS,11,10,1,11,10,0,1,0,0,0,11,11,0,0,32,19,13,32,19,13,0,0,0,0,0,0, ,0,2,0,0
1201020008,12,1,20,8,12320,RIO NEGRO,FRAY BENTOS,19,14,5,19,14,0,5,0,0,0,15,15,0,0,57,27,30,57,27,30,0,0,0,0,0,0, ,0,2,0,0
1201020009,12,1,20,9,12320,RIO NEGRO,FRAY BENTOS,19,13,6,19,13,0,6,0,0,0,13,13,0,0,46,23,23,46,23,23,0,0,0,0,0,0, ,0,2,0,0
1201020010,12,1,20,10,12320,RIO NEGRO,FRAY BENTOS,11,8,3,11,8,0,3,0,0,0,8,8,0,0,32,17,15,32,17,15,0,0,0,0,0,0, ,0,2,0,0
1201020011,12,1,20,11,12320,RIO NEGRO,FRAY BENTOS,15,14,1,15,14,0,1,0,0,0,15,15,0,0,70,42,28,70,42,28,0,0,0,0,0,0, ,0,2,0,0
1201020012,12,1,20,12,12320,RIO NEGRO,FRAY BENTOS,16,16,0,16,16,0,0,0,0,0,17,17,0,0,54,28,26,54,28,26,0,0,0,0,0,0, ,0,2,0,0
1201020013,12,1,20,13,12320,RIO NEGRO,FRAY BENTOS,12,8,4,12,8,0,4,0,0,0,10,10,0,0,34,19,15,34,19,15,0,0,0,0,0,0, ,0,2,0,0
1201020014,12,1,20,14,12320,RIO NEGRO,FRAY BENTOS,22,12,10,22,12,0,10,0,0,0,12,12,0,0,48,23,25,48,23,25,0,0,0,0,0,0, ,0,2,0,0
1201020015,12,1,20,15,12320,RIO NEGRO,FRAY BENTOS,19,17,2,19,17,0,2,0,0,0,21,21,0,0,100,52,48,100,52,48,0,0,0,0,0,0, ,0,2,0,0
1201020016,12,1,20,16,12320,RIO NEGRO,FRAY BENTOS,19,16,3,19,16,0,3,0,0,0,17,17,0,0,54,25,29,54,25,29,0,0,0,0,0,0, ,0,2,0,0
1201020017,12,1,20,17,12320,RIO NEGRO,FRAY BENTOS,12,12,0,12,12,0,0,0,0,0,12,12,0,0,34,16,18,34,16,18,0,0,0,0,0,0, ,0,2,0,0
1201020018,12,1,20,18,12320,RIO NEGRO,FRAY BENTOS,22,20,2,22,20,0,2,0,0,0,21,21,0,0,75,43,32,75,43,32,0,0,0,0,0,0, ,0,2,0,0
1201020021,12,1,20,21,12320,RIO NEGRO,FRAY BENTOS,14,11,3,14,11,0,3,0,0,0,15,15,0,0,50,26,24,50,26,24,0,0,0,0,0,0, ,0,2,0,0
1201020022,12,1,20,22,12320,RIO NEGRO,FRAY BENTOS,16,14,2,16,14,0,2,0,0,0,14,14,0,0,47,26,21,47,26,21,0,0,0,0,0,0, ,0,2,0,0
1201020023,12,1,20,23,12320,RIO NEGRO,FRAY BENTOS,23,22,1,23,22,0,1,0,0,0,22,22,0,0,82,41,41,82,41,41,0,0,0,0,0,0, ,0,2,0,0
1201020024,12,1,20,24,12320,RIO NEGRO,FRAY BENTOS,17,14,3,17,14,0,3,0,0,0,14,14,0,0,60,30,30,60,30,30,0,0,0,0,0,0, ,0,2,0,0
1201020025,12,1,20,25,12320,RIO NEGRO,FRAY BENTOS,45,42,3,45,42,0,3,0,0,0,44,44,0,0,159,79,80,159,79,80,0,0,0,0,0,0, ,0,2,0,0
1201020026,12,1,20,26,12320,RIO NEGRO,FRAY BENTOS,35,23,12,35,23,0,12,0,0,0,23,23,0,0,55,25,30,55,25,30,0,0,0,0,0,0, ,0,2,0,0
1201020400,12,1,20,400,12320,RIO NEGRO,FRAY BENTOS,0,0,0,0,0,0,0,0,0,0,0,0,0,0,0,0,0,0,0,0,0,0,0,0,0,0, ,0,2,0,0
1201020401,12,1,20,401,12320,RIO NEGRO,FRAY BENTOS,0,0,0,0,0,0,0,0,0,0,0,0,0,0,0,0,0,0,0,0,0,0,0,0,0,0, ,0,2,0,0
1201020402,12,1,20,402,12320,RIO NEGRO,FRAY BENTOS,0,0,0,0,0,0,0,0,0,0,0,0,0,0,0,0,0,0,0,0,0,0,0,0,0,0, ,0,2,0,0
1201020403,12,1,20,403,12320,RIO NEGRO,FRAY BENTOS,0,0,0,0,0,0,0,0,0,0,0,0,0,0,0,0,0,0,0,0,0,0,0,0,0,0, ,0,2,0,0
1201020600,12,1,20,600,12320,RIO NEGRO,FRAY BENTOS,25,25,0,25,25,0,0,0,0,0,26,26,0,0,98,50,48,98,50,48,0,0,0,0,0,0, ,0,2,0,0
1201020601,12,1,20,601,12320,RIO NEGRO,FRAY BENTOS,48,42,6,48,42,0,6,0,0,0,42,42,0,0,156,83,73,156,83,73,0,0,0,0,0,0, ,0,2,0,0
1201020800,12,1,20,800,12320,RIO NEGRO,FRAY BENTOS,57,55,2,57,55,0,2,0,0,0,56,56,0,0,206,109,97,206,109,97,0,0,0,0,0,0, ,0,2,0,0
1201025001,12,1,25,1,12320,RIO NEGRO,FRAY BENTOS,19,19,0,19,19,0,0,0,0,0,19,19,0,0,60,27,33,60,27,33,0,0,0,0,0,0, ,0,2,0,0
1201025002,12,1,25,2,12320,RIO NEGRO,FRAY BENTOS,5,5,0,5,5,0,0,0,0,0,5,5,0,0,16,9,7,16,9,7,0,0,0,0,0,0, ,0,2,0,0
1201025003,12,1,25,3,12320,RIO NEGRO,FRAY BENTOS,8,8,0,8,8,0,0,0,0,0,8,8,0,0,24,13,11,24,13,11,0,0,0,0,0,0, ,0,2,0,0
1201025004,12,1,25,4,12320,RIO NEGRO,FRAY BENTOS,9,9,0,9,9,0,0,0,0,0,9,9,0,0,26,9,17,26,9,17,0,0,0,0,0,0, ,0,2,0,0
1201025006,12,1,25,6,12320,RIO NEGRO,FRAY BENTOS,24,23,1,24,23,0,1,0,0,0,23,23,0,0,40,20,20,40,20,20,0,0,0,0,0,0, ,0,2,0,0
1201025007,12,1,25,7,12320,RIO NEGRO,FRAY BENTOS,22,22,0,22,22,0,0,0,0,0,22,22,0,0,77,40,37,77,40,37,0,0,0,0,0,0, ,0,2,0,0
1201025008,12,1,25,8,12320,RIO NEGRO,FRAY BENTOS,20,20,0,20,20,0,0,0,0,0,20,20,0,0,63,28,35,63,28,35,0,0,0,0,0,0, ,0,2,0,0
1201025009,12,1,25,9,12320,RIO NEGRO,FRAY BENTOS,17,17,0,17,17,0,0,0,0,0,17,17,0,0,53,25,28,53,25,28,0,0,0,0,0,0, ,0,2,0,0
1201025010,12,1,25,10,12320,RIO NEGRO,FRAY BENTOS,13,13,0,13,13,1,0,0,0,0,13,13,1,0,36,18,18,36,18,18,3,1,2,0,0,0, ,0,2,0,0
1201025011,12,1,25,11,12320,RIO NEGRO,FRAY BENTOS,12,12,0,12,12,0,0,0,0,0,13,13,0,0,34,19,15,34,19,15,0,0,0,0,0,0, ,0,2,0,0
1201025012,12,1,25,12,12320,RIO NEGRO,FRAY BENTOS,10,9,1,10,9,0,1,0,0,0,9,9,0,0,32,18,14,32,18,14,0,0,0,0,0,0, ,0,2,0,0
1201025013,12,1,25,13,12320,RIO NEGRO,FRAY BENTOS,8,7,1,8,7,0,1,0,0,0,7,7,0,0,16,8,8,16,8,8,0,0,0,0,0,0, ,0,2,0,0
1201025014,12,1,25,14,12320,RIO NEGRO,FRAY BENTOS,6,6,0,6,6,0,0,0,0,0,6,6,0,0,22,13,9,22,13,9,0,0,0,0,0,0, ,0,2,0,0
1201025015,12,1,25,15,12320,RIO NEGRO,FRAY BENTOS,5,5,0,5,5,0,0,0,0,0,5,5,0,0,15,9,6,15,9,6,0,0,0,0,0,0, ,0,2,0,0
1201025016,12,1,25,16,12320,RIO NEGRO,FRAY BENTOS,13,13,0,13,13,0,0,0,0,0,13,13,0,0,34,15,19,34,15,19,0,0,0,0,0,0, ,0,2,0,0
1201025400,12,1,25,400,12320,RIO NEGRO,FRAY BENTOS,0,0,0,0,0,0,0,0,0,0,0,0,0,0,0,0,0,0,0,0,0,0,0,0,0,0, ,0,2,0,0
1201025600,12,1,25,600,12320,RIO NEGRO,FRAY BENTOS,0,0,0,0,0,0,0,0,0,0,0,0,0,0,0,0,0,0,0,0,0,0,0,0,0,0, ,0,2,0,0
1201025601,12,1,25,601,12320,RIO NEGRO,FRAY BENTOS,17,10,7,17,10,0,7,0,0,0,10,10,0,0,38,21,17,38,21,17,0,0,0,0,0,0, ,0,2,0,0
1201025602,12,1,25,602,12320,RIO NEGRO,FRAY BENTOS,5,4,1,5,4,0,1,0,0,0,4,4,0,0,6,3,3,6,3,3,0,0,0,0,0,0, ,0,2,0,0
1201025603,12,1,25,603,12320,RIO NEGRO,FRAY BENTOS,0,0,0,0,0,0,0,0,0,0,0,0,0,0,0,0,0,0,0,0,0,0,0,0,0,0, ,0,2,0,0
1201025801,12,1,25,801,12320,RIO NEGRO,FRAY BENTOS,14,13,1,14,13,0,1,0,0,0,15,15,0,0,38,18,20,38,18,20,0,0,0,0,0,0, ,0,2,0,0
1201026002,12,1,26,2,12722,RIO NEGRO,BARRIO ANGLO,13,9,4,13,9,0,4,0,0,0,9,9,0,0,22,10,12,22,10,12,0,0,0,0,0,0, ,0,2,0,0
1201026003,12,1,26,3,12722,RIO NEGRO,BARRIO ANGLO,10,7,3,10,7,0,3,0,0,0,7,7,0,0,36,22,14,36,22,14,0,0,0,0,0,0, ,0,2,0,0
1201026006,12,1,26,6,12722,RIO NEGRO,BARRIO ANGLO,0,0,0,0,0,0,0,0,0,0,0,0,0,0,0,0,0,0,0,0,0,0,0,0,0,0, ,0,2,0,0
1201026007,12,1,26,7,12722,RIO NEGRO,BARRIO ANGLO,10,9,1,10,9,0,1,0,0,0,10,10,0,0,40,22,18,40,22,18,0,0,0,0,0,0, ,0,2,0,0
1201026008,12,1,26,8,12722,RIO NEGRO,BARRIO ANGLO,8,7,1,8,7,0,1,0,0,0,7,7,0,0,30,13,17,30,13,17,0,0,0,0,0,0, ,0,2,0,0
1201026012,12,1,26,12,12722,RIO NEGRO,BARRIO ANGLO,0,0,0,0,0,0,0,0,0,0,0,0,0,0,0,0,0,0,0,0,0,0,0,0,0,0, ,0,2,0,0
1201026013,12,1,26,13,12722,RIO NEGRO,BARRIO ANGLO,32,30,2,32,30,0,2,0,0,0,30,30,0,0,83,37,46,83,37,46,0,0,0,0,0,0, ,0,2,0,0
1201026014,12,1,26,14,12722,RIO NEGRO,BARRIO ANGLO,4,2,2,4,2,0,2,0,0,0,2,2,0,0,7,4,3,7,4,3,0,0,0,0,0,0, ,0,2,0,0
1201026016,12,1,26,16,12722,RIO NEGRO,BARRIO ANGLO,0,0,0,0,0,0,0,0,0,0,0,0,0,0,0,0,0,0,0,0,0,0,0,0,0,0, ,0,2,0,0
1201026101,12,1,26,101,12722,RIO NEGRO,BARRIO ANGLO,8,8,0,8,8,0,0,0,0,0,8,8,0,0,35,16,19,35,16,19,0,0,0,0,0,0, ,0,2,0,0
1201026400,12,1,26,400,12722,RIO NEGRO,BARRIO ANGLO,0,0,0,0,0,0,0,0,0,0,0,0,0,0,0,0,0,0,0,0,0,0,0,0,0,0, ,0,2,0,0
1201026600,12,1,26,600,12722,RIO NEGRO,BARRIO ANGLO,1,1,0,1,1,0,0,0,0,0,1,1,0,0,2,0,2,2,0,2,0,0,0,0,0,0, ,0,2,0,0
1201026601,12,1,26,601,12722,RIO NEGRO,BARRIO ANGLO,6,6,0,6,6,0,0,0,0,0,6,6,0,0,20,10,10,20,10,10,0,0,0,0,0,0, ,0,2,0,0
1201026602,12,1,26,602,12722,RIO NEGRO,BARRIO ANGLO,12,12,0,12,12,0,0,0,0,0,12,12,0,0,46,30,16,46,30,16,0,0,0,0,0,0, ,0,2,0,0
1201026603,12,1,26,603,12722,RIO NEGRO,BARRIO ANGLO,18,18,0,18,18,0,0,0,0,0,18,18,0,0,71,28,43,71,28,43,0,0,0,0,0,0, ,0,2,0,0
1201026604,12,1,26,604,12722,RIO NEGRO,BARRIO ANGLO,23,23,0,23,23,0,0,0,0,0,25,25,0,0,92,45,47,92,45,47,0,0,0,0,0,0, ,0,2,0,0
1201026605,12,1,26,605,12722,RIO NEGRO,BARRIO ANGLO,4,4,0,4,4,0,0,0,0,0,4,4,0,0,9,3,6,9,3,6,0,0,0,0,0,0, ,0,2,0,0
1201026606,12,1,26,606,12722,RIO NEGRO,BARRIO ANGLO,4,4,0,4,4,0,0,0,0,0,4,4,0,0,13,6,7,13,6,7,0,0,0,0,0,0, ,0,2,0,0
1201026607,12,1,26,607,12722,RIO NEGRO,BARRIO ANGLO,5,5,0,5,5,0,0,0,0,0,5,5,0,0,22,13,9,22,13,9,0,0,0,0,0,0, ,0,2,0,0
1201026608,12,1,26,608,12722,RIO NEGRO,BARRIO ANGLO,23,23,0,23,23,0,0,0,0,0,23,23,0,0,73,41,32,73,41,32,0,0,0,0,0,0, ,0,2,0,0
1201026801,12,1,26,801,12722,RIO NEGRO,BARRIO ANGLO,7,7,0,7,7,0,0,0,0,0,8,8,0,0,36,18,18,36,18,18,0,0,0,0,0,0, ,0,2,0,0
1201026802,12,1,26,802,12722,RIO NEGRO,BARRIO ANGLO,4,4,0,4,4,0,0,0,0,0,4,4,0,0,19,10,9,19,10,9,0,0,0,0,0,0, ,0,2,0,0
1201026803,12,1,26,803,12722,RIO NEGRO,BARRIO ANGLO,6,6,0,6,6,0,0,0,0,0,7,7,0,0,24,14,10,24,14,10,0,0,0,0,0,0, ,0,2,0,0
1201026804,12,1,26,804,12722,RIO NEGRO,BARRIO ANGLO,3,2,1,3,2,0,1,0,0,0,2,2,0,0,7,5,2,7,5,2,0,0,0,0,0,0, ,0,2,0,0
1201026805,12,1,26,805,12722,RIO NEGRO,BARRIO ANGLO,4,3,1,4,3,0,1,0,0,0,3,3,0,0,12,6,6,12,6,6,0,0,0,0,0,0, ,0,2,0,0
1201026806,12,1,26,806,12722,RIO NEGRO,BARRIO ANGLO,5,5,0,5,5,0,0,0,0,0,5,5,0,0,22,10,12,22,10,12,0,0,0,0,0,0, ,0,2,0,0
1201026807,12,1,26,807,12722,RIO NEGRO,BARRIO ANGLO,3,3,0,3,3,0,0,0,0,0,3,3,0,0,5,4,1,5,4,1,0,0,0,0,0,0, ,0,2,0,0
1201026808,12,1,26,808,12722,RIO NEGRO,BARRIO ANGLO,6,5,1,5,4,0,1,1,1,0,13,12,0,1,26,9,17,16,5,11,0,0,0,10,4,6, ,0,2,0,0
1201026810,12,1,26,810,12722,RIO NEGRO,BARRIO ANGLO,2,2,0,2,2,0,0,0,0,0,2,2,0,0,2,1,1,2,1,1,0,0,0,0,0,0, ,0,2,0,0
1201026811,12,1,26,811,12722,RIO NEGRO,BARRIO ANGLO,2,2,0,2,2,0,0,0,0,0,2,2,0,0,7,2,5,7,2,5,0,0,0,0,0,0, ,0,2,0,0
1201026812,12,1,26,812,12722,RIO NEGRO,BARRIO ANGLO,9,7,2,9,7,0,2,0,0,0,7,7,0,0,20,6,14,20,6,14,0,0,0,0,0,0, ,0,2,0,0
1201026813,12,1,26,813,12722,RIO NEGRO,BARRIO ANGLO,0,0,0,0,0,0,0,0,0,0,0,0,0,0,0,0,0,0,0,0,0,0,0,0,0,0, ,0,2,0,0
1201026814,12,1,26,814,12722,RIO NEGRO,BARRIO ANGLO,1,1,0,1,1,0,0,0,0,0,1,1,0,0,4,2,2,4,2,2,0,0,0,0,0,0, ,0,2,0,0
1201028002,12,1,28,2,12320,RIO NEGRO,FRAY BENTOS,13,11,2,13,11,0,2,0,0,0,11,11,0,0,39,21,18,39,21,18,0,0,0,0,0,0, ,0,2,0,0
1201028003,12,1,28,3,12320,RIO NEGRO,FRAY BENTOS,14,11,3,14,11,0,3,0,0,0,11,11,0,0,34,16,18,34,16,18,0,0,0,0,0,0, ,0,2,0,0
1201028004,12,1,28,4,12320,RIO NEGRO,FRAY BENTOS,16,15,1,16,15,1,1,0,0,0,15,15,1,0,60,28,32,60,28,32,3,2,1,0,0,0, ,0,2,0,0
1201028005,12,1,28,5,12320,RIO NEGRO,FRAY BENTOS,14,14,0,14,14,0,0,0,0,0,14,14,0,0,43,22,21,43,22,21,0,0,0,0,0,0, ,0,2,0,0
1201028006,12,1,28,6,12320,RIO NEGRO,FRAY BENTOS,18,18,0,18,18,0,0,0,0,0,18,18,0,0,55,24,31,55,24,31,0,0,0,0,0,0, ,0,2,0,0
1201028007,12,1,28,7,12320,RIO NEGRO,FRAY BENTOS,6,6,0,6,6,0,0,0,0,0,6,6,0,0,21,12,9,21,12,9,0,0,0,0,0,0, ,0,2,0,0
1201028008,12,1,28,8,12320,RIO NEGRO,FRAY BENTOS,3,0,3,3,0,0,3,0,0,0,0,0,0,0,0,0,0,0,0,0,0,0,0,0,0,0, ,0,2,0,0
1201028010,12,1,28,10,12320,RIO NEGRO,FRAY BENTOS,33,15,18,33,15,0,18,0,0,0,15,15,0,0,71,38,33,71,38,33,0,0,0,0,0,0, ,0,2,0,0
1201028011,12,1,28,11,12320,RIO NEGRO,FRAY BENTOS,3,2,1,3,2,0,1,0,0,0,2,2,0,0,3,0,3,3,0,3,0,0,0,0,0,0, ,0,2,0,0
1201028012,12,1,28,12,12320,RIO NEGRO,FRAY BENTOS,18,18,0,18,18,0,0,0,0,0,18,18,0,0,53,22,31,53,22,31,0,0,0,0,0,0, ,0,2,0,0
1201028014,12,1,28,14,12320,RIO NEGRO,FRAY BENTOS,17,17,0,17,17,0,0,0,0,0,17,17,0,0,61,29,32,61,29,32,0,0,0,0,0,0, ,0,2,0,0
1201028015,12,1,28,15,12320,RIO NEGRO,FRAY BENTOS,20,20,0,20,20,0,0,0,0,0,20,20,0,0,68,34,34,68,34,34,0,0,0,0,0,0, ,0,2,0,0
1201028018,12,1,28,18,12320,RIO NEGRO,FRAY BENTOS,21,17,4,21,17,0,4,0,0,0,17,17,0,0,61,30,31,61,30,31,0,0,0,0,0,0, ,0,2,0,0
1201028019,12,1,28,19,12320,RIO NEGRO,FRAY BENTOS,21,20,1,21,20,0,1,0,0,0,20,20,0,0,61,31,30,61,31,30,0,0,0,0,0,0, ,0,2,0,0
1201028021,12,1,28,21,12320,RIO NEGRO,FRAY BENTOS,24,24,0,24,24,0,0,0,0,0,24,24,0,0,65,29,36,65,29,36,0,0,0,0,0,0, ,0,2,0,0
1201028022,12,1,28,22,12320,RIO NEGRO,FRAY BENTOS,1,0,1,1,0,0,1,0,0,0,0,0,0,0,0,0,0,0,0,0,0,0,0,0,0,0, ,0,2,0,0
1201028024,12,1,28,24,12320,RIO NEGRO,FRAY BENTOS,19,18,1,19,18,0,1,0,0,0,18,18,0,0,47,23,24,47,23,24,0,0,0,0,0,0, ,0,2,0,0
1201028025,12,1,28,25,12320,RIO NEGRO,FRAY BENTOS,22,20,2,22,20,0,2,0,0,0,21,21,0,0,63,33,30,63,33,30,0,0,0,0,0,0, ,0,2,0,0
1201028026,12,1,28,26,12320,RIO NEGRO,FRAY BENTOS,22,20,2,22,20,0,2,0,0,0,20,20,0,0,53,24,29,53,24,29,0,0,0,0,0,0, ,0,2,0,0
1201028400,12,1,28,400,12320,RIO NEGRO,FRAY BENTOS,0,0,0,0,0,0,0,0,0,0,0,0,0,0,0,0,0,0,0,0,0,0,0,0,0,0, ,0,2,0,0
1201028401,12,1,28,401,12320,RIO NEGRO,FRAY BENTOS,0,0,0,0,0,0,0,0,0,0,0,0,0,0,0,0,0,0,0,0,0,0,0,0,0,0, ,0,2,0,0
1201028600,12,1,28,600,12320,RIO NEGRO,FRAY BENTOS,21,19,2,21,19,0,2,0,0,0,19,19,0,0,56,25,31,56,25,31,0,0,0,0,0,0, ,0,2,0,0
1201028601,12,1,28,601,12320,RIO NEGRO,FRAY BENTOS,18,17,1,18,17,0,1,0,0,0,17,17,0,0,78,38,40,78,38,40,0,0,0,0,0,0, ,0,2,0,0
1201028602,12,1,28,602,12320,RIO NEGRO,FRAY BENTOS,22,20,2,22,20,0,2,0,0,0,20,20,0,0,55,27,28,55,27,28,0,0,0,0,0,0, ,0,2,0,0
1201028603,12,1,28,603,12320,RIO NEGRO,FRAY BENTOS,18,16,2,18,16,0,2,0,0,0,17,17,0,0,69,39,30,69,39,30,0,0,0,0,0,0, ,0,2,0,0
1201028604,12,1,28,604,12320,RIO NEGRO,FRAY BENTOS,0,0,0,0,0,0,0,0,0,0,0,0,0,0,0,0,0,0,0,0,0,0,0,0,0,0, ,0,2,0,0
1201028605,12,1,28,605,12320,RIO NEGRO,FRAY BENTOS,10,8,2,10,8,0,2,0,0,0,8,8,0,0,21,11,10,21,11,10,0,0,0,0,0,0, ,0,2,0,0
1201028606,12,1,28,606,12320,RIO NEGRO,FRAY BENTOS,22,21,1,22,21,0,1,0,0,0,21,21,0,0,64,30,34,64,30,34,0,0,0,0,0,0, ,0,2,0,0
1201028607,12,1,28,607,12320,RIO NEGRO,FRAY BENTOS,4,4,0,4,4,0,0,0,0,0,4,4,0,0,15,7,8,15,7,8,0,0,0,0,0,0, ,0,2,0,0
1201028608,12,1,28,608,12320,RIO NEGRO,FRAY BENTOS,24,20,4,24,20,0,4,0,0,0,20,20,0,0,72,38,34,72,38,34,0,0,0,0,0,0, ,0,2,0,0
1201028609,12,1,28,609,12320,RIO NEGRO,FRAY BENTOS,6,6,0,6,6,0,0,0,0,0,6,6,0,0,21,12,9,21,12,9,0,0,0,0,0,0, ,0,2,0,0
1201028610,12,1,28,610,12320,RIO NEGRO,FRAY BENTOS,22,20,2,22,20,0,2,0,0,0,20,20,0,0,91,52,39,91,52,39,0,0,0,0,0,0, ,0,2,0,0
1201028611,12,1,28,611,12320,RIO NEGRO,FRAY BENTOS,20,20,0,20,20,0,0,0,0,0,20,20,0,0,75,34,41,75,34,41,0,0,0,0,0,0, ,0,2,0,0
1201028612,12,1,28,612,12320,RIO NEGRO,FRAY BENTOS,4,0,4,4,0,0,4,0,0,0,0,0,0,0,0,0,0,0,0,0,0,0,0,0,0,0, ,0,2,0,0
1201028613,12,1,28,613,12320,RIO NEGRO,FRAY BENTOS,31,24,7,31,24,0,7,0,0,0,24,24,0,0,54,30,24,54,30,24,0,0,0,0,0,0, ,0,2,0,0
1201028614,12,1,28,614,12320,RIO NEGRO,FRAY BENTOS,8,6,2,8,6,0,2,0,0,0,6,6,0,0,20,9,11,20,9,11,0,0,0,0,0,0, ,0,2,0,0
1201028615,12,1,28,615,12320,RIO NEGRO,FRAY BENTOS,31,24,7,31,24,0,7,0,0,0,24,24,0,0,80,40,40,80,40,40,0,0,0,0,0,0, ,0,2,0,0
1201028616,12,1,28,616,12320,RIO NEGRO,FRAY BENTOS,10,9,1,10,9,0,1,0,0,0,9,9,0,0,30,15,15,30,15,15,0,0,0,0,0,0, ,0,2,0,0
1201028617,12,1,28,617,12320,RIO NEGRO,FRAY BENTOS,3,3,0,3,3,0,0,0,0,0,3,3,0,0,9,5,4,9,5,4,0,0,0,0,0,0, ,0,2,0,0
1201028618,12,1,28,618,12320,RIO NEGRO,FRAY BENTOS,4,2,2,4,2,0,2,0,0,0,2,2,0,0,6,4,2,6,4,2,0,0,0,0,0,0, ,0,2,0,0
1201028619,12,1,28,619,12320,RIO NEGRO,FRAY BENTOS,12,8,4,12,8,0,4,0,0,0,8,8,0,0,25,11,14,25,11,14,0,0,0,0,0,0, ,0,2,0,0
1201028805,12,1,28,805,12320,RIO NEGRO,FRAY BENTOS,27,27,0,27,27,0,0,0,0,0,27,27,0,0,101,49,52,101,49,52,0,0,0,0,0,0, ,0,2,0,0
1201028806,12,1,28,806,12320,RIO NEGRO,FRAY BENTOS,1,0,1,1,0,0,1,0,0,0,0,0,0,0,0,0,0,0,0,0,0,0,0,0,0,0, ,0,2,0,0
1201028807,12,1,28,807,12320,RIO NEGRO,FRAY BENTOS,25,22,3,25,22,0,3,0,0,0,24,24,0,0,94,39,55,94,39,55,0,0,0,0,0,0, ,0,2,0,0
1201028808,12,1,28,808,12320,RIO NEGRO,FRAY BENTOS,22,19,3,22,19,0,3,0,0,0,19,19,0,0,60,30,30,60,30,30,0,0,0,0,0,0, ,0,2,0,0
1201028809,12,1,28,809,12320,RIO NEGRO,FRAY BENTOS,0,0,0,0,0,0,0,0,0,0,0,0,0,0,0,0,0,0,0,0,0,0,0,0,0,0, ,0,2,0,0
1201118003,12,1,118,3,12320,RIO NEGRO,FRAY BENTOS,17,11,6,17,11,0,6,0,0,0,11,11,0,0,38,20,18,38,20,18,0,0,0,0,0,0, ,0,2,0,0
1201118004,12,1,118,4,12320,RIO NEGRO,FRAY BENTOS,15,11,4,15,11,0,4,0,0,0,11,11,0,0,44,22,22,44,22,22,0,0,0,0,0,0, ,0,2,0,0
1201118005,12,1,118,5,12320,RIO NEGRO,FRAY BENTOS,15,13,2,15,13,0,2,0,0,0,13,13,0,0,41,20,21,41,20,21,0,0,0,0,0,0, ,0,2,0,0
1201118006,12,1,118,6,12320,RIO NEGRO,FRAY BENTOS,8,7,1,8,7,0,1,0,0,0,7,7,0,0,27,19,8,27,19,8,0,0,0,0,0,0, ,0,2,0,0
1201118007,12,1,118,7,12320,RIO NEGRO,FRAY BENTOS,23,21,2,23,21,0,2,0,0,0,21,21,0,0,76,35,41,76,35,41,0,0,0,0,0,0, ,0,2,0,0
1201118009,12,1,118,9,12320,RIO NEGRO,FRAY BENTOS,28,28,0,28,28,0,0,0,0,0,29,29,0,0,120,61,59,120,61,59,0,0,0,0,0,0, ,0,2,0,0
1201118010,12,1,118,10,12320,RIO NEGRO,FRAY BENTOS,12,11,1,12,11,0,1,0,0,0,11,11,0,0,29,13,16,29,13,16,0,0,0,0,0,0, ,0,2,0,0
1201118011,12,1,118,11,12320,RIO NEGRO,FRAY BENTOS,16,15,1,16,15,0,1,0,0,0,15,15,0,0,56,29,27,56,29,27,0,0,0,0,0,0, ,0,2,0,0
1201118014,12,1,118,14,12320,RIO NEGRO,FRAY BENTOS,12,11,1,12,11,0,1,0,0,0,11,11,0,0,31,19,12,31,19,12,0,0,0,0,0,0, ,0,2,0,0
1201118015,12,1,118,15,12320,RIO NEGRO,FRAY BENTOS,9,7,2,9,7,0,2,0,0,0,7,7,0,0,28,15,13,28,15,13,0,0,0,0,0,0, ,0,2,0,0
1201118016,12,1,118,16,12320,RIO NEGRO,FRAY BENTOS,0,0,0,0,0,0,0,0,0,0,0,0,0,0,0,0,0,0,0,0,0,0,0,0,0,0, ,0,2,0,0
1201118017,12,1,118,17,12320,RIO NEGRO,FRAY BENTOS,12,11,1,12,11,0,1,0,0,0,11,11,0,0,36,14,22,36,14,22,0,0,0,0,0,0, ,0,2,0,0
1201118018,12,1,118,18,12320,RIO NEGRO,FRAY BENTOS,12,11,1,12,11,0,1,0,0,0,11,11,0,0,40,23,17,40,23,17,0,0,0,0,0,0, ,0,2,0,0
1201118019,12,1,118,19,12320,RIO NEGRO,FRAY BENTOS,15,12,3,15,12,0,3,0,0,0,12,12,0,0,49,27,22,49,27,22,0,0,0,0,0,0, ,0,2,0,0
1201118020,12,1,118,20,12320,RIO NEGRO,FRAY BENTOS,19,16,3,19,16,0,3,0,0,0,16,16,0,0,49,25,24,49,25,24,0,0,0,0,0,0, ,0,2,0,0
1201118022,12,1,118,22,12320,RIO NEGRO,FRAY BENTOS,16,13,3,16,13,0,3,0,0,0,13,13,0,0,58,32,26,58,32,26,0,0,0,0,0,0, ,0,2,0,0
1201118038,12,1,118,38,12320,RIO NEGRO,FRAY BENTOS,1,1,0,1,1,0,0,0,0,0,1,1,0,0,3,2,1,3,2,1,0,0,0,0,0,0, ,0,2,0,0
1201118039,12,1,118,39,12320,RIO NEGRO,FRAY BENTOS,7,6,1,7,6,0,1,0,0,0,6,6,0,0,20,10,10,20,10,10,0,0,0,0,0,0, ,0,2,0,0
1201118040,12,1,118,40,12320,RIO NEGRO,FRAY BENTOS,2,2,0,2,2,0,0,0,0,0,2,2,0,0,5,3,2,5,3,2,0,0,0,0,0,0, ,0,2,0,0
1201118042,12,1,118,42,12320,RIO NEGRO,FRAY BENTOS,1,1,0,1,1,0,0,0,0,0,1,1,0,0,4,3,1,4,3,1,0,0,0,0,0,0, ,0,2,0,0
1201118043,12,1,118,43,12320,RIO NEGRO,FRAY BENTOS,12,12,0,12,12,0,0,0,0,0,12,12,0,0,48,20,28,48,20,28,0,0,0,0,0,0, ,0,2,0,0
1201118046,12,1,118,46,12320,RIO NEGRO,FRAY BENTOS,14,14,0,14,14,0,0,0,0,0,14,14,0,0,18,6,12,18,6,12,0,0,0,0,0,0, ,0,2,0,0
1201118047,12,1,118,47,12320,RIO NEGRO,FRAY BENTOS,16,14,2,16,14,0,2,0,0,0,14,14,0,0,18,6,12,18,6,12,0,0,0,0,0,0, ,0,2,0,0
1201118048,12,1,118,48,12320,RIO NEGRO,FRAY BENTOS,0,0,0,0,0,0,0,0,0,0,0,0,0,0,0,0,0,0,0,0,0,0,0,0,0,0, ,0,2,0,0
1201118049,12,1,118,49,12320,RIO NEGRO,FRAY BENTOS,18,17,1,18,17,0,1,0,0,0,18,18,0,0,54,27,27,54,27,27,0,0,0,0,0,0, ,0,2,0,0
1201118050,12,1,118,50,12320,RIO NEGRO,FRAY BENTOS,10,7,3,10,7,0,3,0,0,0,7,7,0,0,21,9,12,21,9,12,0,0,0,0,0,0, ,0,2,0,0
1201118051,12,1,118,51,12320,RIO NEGRO,FRAY BENTOS,7,7,0,7,7,0,0,0,0,0,7,7,0,0,30,19,11,30,19,11,0,0,0,0,0,0, ,0,2,0,0
1201118052,12,1,118,52,12320,RIO NEGRO,FRAY BENTOS,5,5,0,5,5,0,0,0,0,0,5,5,0,0,15,5,10,15,5,10,0,0,0,0,0,0, ,0,2,0,0
1201118053,12,1,118,53,12320,RIO NEGRO,FRAY BENTOS,10,10,0,10,10,0,0,0,0,0,10,10,0,0,40,16,24,40,16,24,0,0,0,0,0,0, ,0,2,0,0
1201118054,12,1,118,54,12320,RIO NEGRO,FRAY BENTOS,16,16,0,16,16,0,0,0,0,0,17,17,0,0,59,29,30,59,29,30,0,0,0,0,0,0, ,0,2,0,0
1201118055,12,1,118,55,12320,RIO NEGRO,FRAY BENTOS,12,12,0,12,12,0,0,0,0,0,12,12,0,0,43,14,29,43,14,29,0,0,0,0,0,0, ,0,2,0,0
1201118056,12,1,118,56,12320,RIO NEGRO,FRAY BENTOS,44,40,4,44,40,0,4,0,0,0,41,41,0,0,171,89,82,171,89,82,0,0,0,0,0,0, ,0,2,0,0
1201118400,12,1,118,400,12320,RIO NEGRO,FRAY BENTOS,0,0,0,0,0,0,0,0,0,0,0,0,0,0,0,0,0,0,0,0,0,0,0,0,0,0, ,0,2,0,0
1201118600,12,1,118,600,12320,RIO NEGRO,FRAY BENTOS,12,12,0,12,12,0,0,0,0,0,12,12,0,0,53,27,26,53,27,26,0,0,0,0,0,0, ,0,2,0,0
1201118700,12,1,118,700,12320,RIO NEGRO,FRAY BENTOS,81,76,5,81,76,0,5,0,0,0,77,77,0,0,244,132,112,244,132,112,0,0,0,0,0,0, ,0,2,0,0
1201118701,12,1,118,701,12320,RIO NEGRO,FRAY BENTOS,10,10,0,10,10,0,0,0,0,0,11,11,0,0,65,29,36,65,29,36,0,0,0,0,0,0, ,0,2,0,0
1201118702,12,1,118,702,12320,RIO NEGRO,FRAY BENTOS,12,12,0,12,12,0,0,0,0,0,12,12,0,0,75,40,35,75,40,35,0,0,0,0,0,0, ,0,2,0,0
1201118703,12,1,118,703,12320,RIO NEGRO,FRAY BENTOS,9,9,0,9,9,0,0,0,0,0,9,9,0,0,44,24,20,44,24,20,0,0,0,0,0,0, ,0,2,0,0
1201118800,12,1,118,800,12320,RIO NEGRO,FRAY BENTOS,13,13,0,13,13,0,0,0,0,0,13,13,0,0,59,29,30,59,29,30,0,0,0,0,0,0, ,0,2,0,0
1201118801,12,1,118,801,12320,RIO NEGRO,FRAY BENTOS,12,12,0,12,12,0,0,0,0,0,12,12,0,0,63,30,33,63,30,33,0,0,0,0,0,0, ,0,2,0,0
1201118802,12,1,118,802,12320,RIO NEGRO,FRAY BENTOS,13,13,0,13,13,0,0,0,0,0,13,13,0,0,62,32,30,62,32,30,0,0,0,0,0,0, ,0,2,0,0
1201118804,12,1,118,804,12320,RIO NEGRO,FRAY BENTOS,0,0,0,0,0,0,0,0,0,0,0,0,0,0,0,0,0,0,0,0,0,0,0,0,0,0, ,0,2,0,0
1201118805,12,1,118,805,12320,RIO NEGRO,FRAY BENTOS,28,28,0,28,28,0,0,0,0,0,32,32,0,0,140,75,65,140,75,65,0,0,0,0,0,0, ,0,2,0,0
1201218017,12,1,218,17,12320,RIO NEGRO,FRAY BENTOS,13,12,1,13,12,0,1,0,0,0,12,12,0,0,41,20,21,41,20,21,0,0,0,0,0,0, ,0,2,0,0
1201218018,12,1,218,18,12320,RIO NEGRO,FRAY BENTOS,23,20,3,23,20,0,3,0,0,0,20,20,0,0,56,32,24,56,32,24,0,0,0,0,0,0, ,0,2,0,0
1201218019,12,1,218,19,12320,RIO NEGRO,FRAY BENTOS,20,18,2,20,18,0,2,0,0,0,18,18,0,0,60,22,38,60,22,38,0,0,0,0,0,0, ,0,2,0,0
1201218020,12,1,218,20,12320,RIO NEGRO,FRAY BENTOS,10,8,2,10,8,0,2,0,0,0,8,8,0,0,17,8,9,17,8,9,0,0,0,0,0,0, ,0,2,0,0
1201218021,12,1,218,21,12320,RIO NEGRO,FRAY BENTOS,16,12,4,16,12,0,4,0,0,0,14,14,0,0,39,16,23,39,16,23,0,0,0,0,0,0, ,0,2,0,0
1201218022,12,1,218,22,12320,RIO NEGRO,FRAY BENTOS,24,18,6,24,18,0,6,0,0,0,18,18,0,0,60,31,29,60,31,29,0,0,0,0,0,0, ,0,2,0,0
1201218023,12,1,218,23,12320,RIO NEGRO,FRAY BENTOS,18,15,3,18,15,0,3,0,0,0,15,15,0,0,55,26,29,55,26,29,0,0,0,0,0,0, ,0,2,0,0
1201218024,12,1,218,24,12320,RIO NEGRO,FRAY BENTOS,12,12,0,12,12,0,0,0,0,0,13,13,0,0,50,24,26,50,24,26,0,0,0,0,0,0, ,0,2,0,0
1201218025,12,1,218,25,12320,RIO NEGRO,FRAY BENTOS,7,7,0,7,7,0,0,0,0,0,7,7,0,0,29,11,18,29,11,18,0,0,0,0,0,0, ,0,2,0,0
1201218026,12,1,218,26,12320,RIO NEGRO,FRAY BENTOS,24,17,7,24,17,0,7,0,0,0,17,17,0,0,50,23,27,50,23,27,0,0,0,0,0,0, ,0,2,0,0
1201218027,12,1,218,27,12320,RIO NEGRO,FRAY BENTOS,13,11,2,13,11,0,2,0,0,0,11,11,0,0,33,12,21,33,12,21,0,0,0,0,0,0, ,0,2,0,0
1201218028,12,1,218,28,12320,RIO NEGRO,FRAY BENTOS,19,19,0,19,19,0,0,0,0,0,19,19,0,0,70,42,28,70,42,28,0,0,0,0,0,0, ,0,2,0,0
1201218029,12,1,218,29,12320,RIO NEGRO,FRAY BENTOS,0,0,0,0,0,0,0,0,0,0,0,0,0,0,0,0,0,0,0,0,0,0,0,0,0,0, ,0,2,0,0
1201218030,12,1,218,30,12320,RIO NEGRO,FRAY BENTOS,30,26,4,29,25,0,4,1,1,0,26,25,0,1,134,62,72,113,59,54,0,0,0,21,3,18, ,0,2,0,0
1201218031,12,1,218,31,12320,RIO NEGRO,FRAY BENTOS,31,29,2,31,29,0,2,0,0,0,29,29,0,0,119,57,62,119,57,62,0,0,0,0,0,0, ,0,2,0,0
1201218032,12,1,218,32,12320,RIO NEGRO,FRAY BENTOS,56,50,6,56,50,0,6,0,0,0,50,50,0,0,165,81,84,165,81,84,0,0,0,0,0,0, ,0,2,0,0
1201218033,12,1,218,33,12320,RIO NEGRO,FRAY BENTOS,46,40,6,46,40,0,6,0,0,0,46,46,0,0,164,86,78,164,86,78,0,0,0,0,0,0, ,0,2,0,0
1201218034,12,1,218,34,12320,RIO NEGRO,FRAY BENTOS,70,60,10,70,60,0,10,0,0,0,63,63,0,0,232,114,118,232,114,118,0,0,0,0,0,0, ,0,2,0,0
1201218035,12,1,218,35,12320,RIO NEGRO,FRAY BENTOS,69,62,7,69,62,0,7,0,0,0,65,65,0,0,176,88,88,176,88,88,0,0,0,0,0,0, ,0,2,0,0
1201218039,12,1,218,39,12320,RIO NEGRO,FRAY BENTOS,4,4,0,4,4,0,0,0,0,0,5,5,0,0,15,7,8,15,7,8,0,0,0,0,0,0, ,0,2,0,0
1201218040,12,1,218,40,12320,RIO NEGRO,FRAY BENTOS,9,9,0,9,9,0,0,0,0,0,9,9,0,0,21,12,9,21,12,9,0,0,0,0,0,0, ,0,2,0,0
1201218041,12,1,218,41,12320,RIO NEGRO,FRAY BENTOS,7,7,0,7,7,0,0,0,0,0,7,7,0,0,19,9,10,19,9,10,0,0,0,0,0,0, ,0,2,0,0
1201218042,12,1,218,42,12320,RIO NEGRO,FRAY BENTOS,5,5,0,5,5,0,0,0,0,0,5,5,0,0,24,14,10,24,14,10,0,0,0,0,0,0, ,0,2,0,0
1201218043,12,1,218,43,12320,RIO NEGRO,FRAY BENTOS,6,6,0,6,6,0,0,0,0,0,7,7,0,0,16,7,9,16,7,9,0,0,0,0,0,0, ,0,2,0,0
1201218045,12,1,218,45,12320,RIO NEGRO,FRAY BENTOS,6,6,0,6,6,0,0,0,0,0,7,7,0,0,17,9,8,17,9,8,0,0,0,0,0,0, ,0,2,0,0
1201218046,12,1,218,46,12320,RIO NEGRO,FRAY BENTOS,0,0,0,0,0,0,0,0,0,0,0,0,0,0,0,0,0,0,0,0,0,0,0,0,0,0, ,0,2,0,0
1201218047,12,1,218,47,12320,RIO NEGRO,FRAY BENTOS,6,6,0,6,6,0,0,0,0,0,7,7,0,0,19,10,9,19,10,9,0,0,0,0,0,0, ,0,2,0,0
1201218048,12,1,218,48,12320,RIO NEGRO,FRAY BENTOS,7,7,0,7,7,0,0,0,0,0,7,7,0,0,24,12,12,24,12,12,0,0,0,0,0,0, ,0,2,0,0
1201218050,12,1,218,50,12320,RIO NEGRO,FRAY BENTOS,4,4,0,4,4,0,0,0,0,0,4,4,0,0,9,5,4,9,5,4,0,0,0,0,0,0, ,0,2,0,0
1201218400,12,1,218,400,12320,RIO NEGRO,FRAY BENTOS,0,0,0,0,0,0,0,0,0,0,0,0,0,0,0,0,0,0,0,0,0,0,0,0,0,0, ,0,2,0,0
1201218401,12,1,218,401,12320,RIO NEGRO,FRAY BENTOS,0,0,0,0,0,0,0,0,0,0,0,0,0,0,0,0,0,0,0,0,0,0,0,0,0,0, ,0,2,0,0
1201218402,12,1,218,402,12320,RIO NEGRO,FRAY BENTOS,0,0,0,0,0,0,0,0,0,0,0,0,0,0,0,0,0,0,0,0,0,0,0,0,0,0, ,0,2,0,0
1201218500,12,1,218,500,12320,RIO NEGRO,FRAY BENTOS,0,0,0,0,0,0,0,0,0,0,0,0,0,0,0,0,0,0,0,0,0,0,0,0,0,0, ,0,2,0,0
1201218600,12,1,218,600,12320,RIO NEGRO,FRAY BENTOS,7,7,0,7,7,0,0,0,0,0,7,7,0,0,17,7,10,17,7,10,0,0,0,0,0,0, ,0,2,0,0
1201218601,12,1,218,601,12320,RIO NEGRO,FRAY BENTOS,7,6,1,7,6,0,1,0,0,0,6,6,0,0,17,5,12,17,5,12,0,0,0,0,0,0, ,0,2,0,0
1201218800,12,1,218,800,12320,RIO NEGRO,FRAY BENTOS,0,0,0,0,0,0,0,0,0,0,0,0,0,0,0,0,0,0,0,0,0,0,0,0,0,0, ,0,2,0,0
1201218802,12,1,218,802,12320,RIO NEGRO,FRAY BENTOS,8,7,1,8,7,0,1,0,0,0,7,7,0,0,19,6,13,19,6,13,0,0,0,0,0,0, ,0,2,0,0
1201218803,12,1,218,803,12320,RIO NEGRO,FRAY BENTOS,3,3,0,3,3,0,0,0,0,0,3,3,0,0,7,3,4,7,3,4,0,0,0,0,0,0, ,0,2,0,0
1201218804,12,1,218,804,12320,RIO NEGRO,FRAY BENTOS,0,0,0,0,0,0,0,0,0,0,0,0,0,0,0,0,0,0,0,0,0,0,0,0,0,0, ,0,2,0,0
1301003001,13,1,3,1,13220,RIVERA,RIVERA,29,23,6,29,23,0,6,0,0,0,23,23,0,0,67,34,33,67,34,33,0,0,0,0,0,0, ,0,1,0,0
1301003002,13,1,3,2,13220,RIVERA,RIVERA,27,26,1,27,26,0,1,0,0,0,26,26,0,0,81,35,46,81,35,46,0,0,0,0,0,0, ,0,1,0,0
1301003003,13,1,3,3,13220,RIVERA,RIVERA,24,23,1,23,23,0,0,1,0,1,23,23,0,0,61,25,36,61,25,36,0,0,0,0,0,0, ,0,1,0,0
1301003004,13,1,3,4,13220,RIVERA,RIVERA,27,22,5,27,22,0,5,0,0,0,22,22,0,0,65,36,29,65,36,29,0,0,0,0,0,0, ,0,1,0,0
1301003005,13,1,3,5,13220,RIVERA,RIVERA,41,35,6,41,35,0,6,0,0,0,35,35,0,0,116,49,67,116,49,67,0,0,0,0,0,0, ,0,1,0,0
1301003006,13,1,3,6,13220,RIVERA,RIVERA,28,26,2,28,26,0,2,0,0,0,26,26,0,0,77,40,37,77,40,37,0,0,0,0,0,0, ,0,1,0,0
1301003007,13,1,3,7,13220,RIVERA,RIVERA,33,30,3,33,30,0,3,0,0,0,30,30,0,0,88,44,44,88,44,44,0,0,0,0,0,0, ,0,1,0,0
1301003008,13,1,3,8,13220,RIVERA,RIVERA,35,33,2,35,33,0,2,0,0,0,33,33,0,0,100,45,55,100,45,55,0,0,0,0,0,0, ,0,1,0,0
1301003009,13,1,3,9,13220,RIVERA,RIVERA,24,23,1,24,23,0,1,0,0,0,23,23,0,0,59,23,36,59,23,36,0,0,0,0,0,0, ,0,1,0,0
1301003010,13,1,3,10,13220,RIVERA,RIVERA,45,37,8,45,37,0,8,0,0,0,37,37,0,0,104,53,51,104,53,51,0,0,0,0,0,0, ,0,1,0,0
1301003011,13,1,3,11,13220,RIVERA,RIVERA,31,28,3,31,28,0,3,0,0,0,28,28,0,0,75,33,42,75,33,42,0,0,0,0,0,0, ,0,1,0,0
1301003012,13,1,3,12,13220,RIVERA,RIVERA,25,25,0,25,25,0,0,0,0,0,25,25,0,0,68,29,39,68,29,39,0,0,0,0,0,0, ,0,1,0,0
1301003013,13,1,3,13,13220,RIVERA,RIVERA,23,21,2,23,21,0,2,0,0,0,21,21,0,0,52,16,36,52,16,36,0,0,0,0,0,0, ,0,1,0,0
1301003014,13,1,3,14,13220,RIVERA,RIVERA,37,36,1,37,36,0,1,0,0,0,36,36,0,0,110,49,61,110,49,61,0,0,0,0,0,0, ,0,1,0,0
1301003015,13,1,3,15,13220,RIVERA,RIVERA,28,23,5,27,23,0,4,1,0,1,23,23,0,0,65,35,30,65,35,30,0,0,0,0,0,0, ,0,1,0,0
1301003016,13,1,3,16,13220,RIVERA,RIVERA,42,37,5,42,37,0,5,0,0,0,37,37,0,0,103,56,47,103,56,47,0,0,0,0,0,0, ,0,1,0,0
1301003017,13,1,3,17,13220,RIVERA,RIVERA,37,30,7,37,30,0,7,0,0,0,33,33,0,0,103,50,53,103,50,53,0,0,0,0,0,0, ,0,1,0,0
1301003018,13,1,3,18,13220,RIVERA,RIVERA,31,30,1,31,30,0,1,0,0,0,30,30,0,0,93,43,50,93,43,50,0,0,0,0,0,0, ,0,1,0,0
1301003019,13,1,3,19,13220,RIVERA,RIVERA,27,27,0,27,27,0,0,0,0,0,27,27,0,0,79,37,42,79,37,42,0,0,0,0,0,0, ,0,1,0,0
1301003020,13,1,3,20,13220,RIVERA,RIVERA,25,24,1,25,24,0,1,0,0,0,24,24,0,0,74,38,36,74,38,36,0,0,0,0,0,0, ,0,1,0,0
1301003021,13,1,3,21,13220,RIVERA,RIVERA,29,29,0,29,29,0,0,0,0,0,29,29,0,0,86,43,43,86,43,43,0,0,0,0,0,0, ,0,1,0,0
1301003022,13,1,3,22,13220,RIVERA,RIVERA,27,26,1,27,26,0,1,0,0,0,26,26,0,0,68,31,37,68,31,37,0,0,0,0,0,0, ,0,1,0,0
1301003023,13,1,3,23,13220,RIVERA,RIVERA,41,35,6,41,35,0,6,0,0,0,35,35,0,0,101,43,58,101,43,58,0,0,0,0,0,0, ,0,1,0,0
1301003024,13,1,3,24,13220,RIVERA,RIVERA,31,28,3,31,28,0,3,0,0,0,30,30,0,0,76,31,45,76,31,45,0,0,0,0,0,0, ,0,1,0,0
1301004001,13,1,4,1,13220,RIVERA,RIVERA,26,25,1,25,24,0,1,1,1,0,25,24,0,1,108,36,72,82,35,47,0,0,0,26,1,25, ,0,1,0,0
1301004002,13,1,4,2,13220,RIVERA,RIVERA,23,23,0,23,23,0,0,0,0,0,23,23,0,0,59,25,34,59,25,34,0,0,0,0,0,0, ,0,1,0,0
1301004003,13,1,4,3,13220,RIVERA,RIVERA,44,40,4,44,40,0,4,0,0,0,40,40,0,0,104,51,53,104,51,53,0,0,0,0,0,0, ,0,1,0,0
1301004004,13,1,4,4,13220,RIVERA,RIVERA,11,10,1,10,9,0,1,1,1,0,11,10,0,1,52,20,32,30,13,17,0,0,0,22,7,15, ,0,1,0,0
1301004005,13,1,4,5,13220,RIVERA,RIVERA,27,24,3,27,24,0,3,0,0,0,25,25,0,0,77,33,44,77,33,44,0,0,0,0,0,0, ,0,1,0,0
1301004006,13,1,4,6,13220,RIVERA,RIVERA,49,43,6,49,43,0,6,0,0,0,43,43,0,0,115,55,60,115,55,60,0,0,0,0,0,0, ,0,1,0,0
1301004007,13,1,4,7,13220,RIVERA,RIVERA,41,39,2,41,39,0,2,0,0,0,39,39,0,0,101,49,52,101,49,52,0,0,0,0,0,0, ,0,1,0,0
1301004008,13,1,4,8,13220,RIVERA,RIVERA,12,12,0,12,12,0,0,0,0,0,12,12,0,0,25,8,17,25,8,17,0,0,0,0,0,0, ,0,1,0,0
1301004009,13,1,4,9,13220,RIVERA,RIVERA,31,22,9,31,22,0,9,0,0,0,24,24,0,0,69,28,41,69,28,41,0,0,0,0,0,0, ,0,1,0,0
1301004010,13,1,4,10,13220,RIVERA,RIVERA,45,43,2,45,43,0,2,0,0,0,43,43,0,0,112,51,61,112,51,61,0,0,0,0,0,0, ,0,1,0,0
1301004011,13,1,4,11,13220,RIVERA,RIVERA,35,32,3,35,32,0,3,0,0,0,32,32,0,0,94,43,51,94,43,51,0,0,0,0,0,0, ,0,1,0,0
1301004012,13,1,4,12,13220,RIVERA,RIVERA,34,30,4,34,30,0,4,0,0,0,30,30,0,0,87,32,55,87,32,55,0,0,0,0,0,0, ,0,1,0,0
1301004013,13,1,4,13,13220,RIVERA,RIVERA,26,22,4,26,22,0,4,0,0,0,22,22,0,0,58,27,31,58,27,31,0,0,0,0,0,0, ,0,1,0,0
1301004014,13,1,4,14,13220,RIVERA,RIVERA,29,26,3,29,26,0,3,0,0,0,26,26,0,0,77,37,40,77,37,40,0,0,0,0,0,0, ,0,1,0,0
1301004015,13,1,4,15,13220,RIVERA,RIVERA,37,32,5,37,32,0,5,0,0,0,32,32,0,0,94,39,55,94,39,55,0,0,0,0,0,0, ,0,1,0,0
1301004016,13,1,4,16,13220,RIVERA,RIVERA,32,29,3,32,29,0,3,0,0,0,32,32,0,0,87,41,46,87,41,46,0,0,0,0,0,0, ,0,1,0,0
1301004017,13,1,4,17,13220,RIVERA,RIVERA,36,35,1,36,35,0,1,0,0,0,36,36,0,0,108,49,59,108,49,59,0,0,0,0,0,0, ,0,1,0,0
1301004018,13,1,4,18,13220,RIVERA,RIVERA,22,21,1,22,21,0,1,0,0,0,21,21,0,0,70,40,30,70,40,30,0,0,0,0,0,0, ,0,1,0,0
1301005001,13,1,5,1,13220,RIVERA,RIVERA,9,7,2,9,7,0,2,0,0,0,8,8,0,0,24,6,18,24,6,18,0,0,0,0,0,0, ,0,1,0,0
1301005002,13,1,5,2,13220,RIVERA,RIVERA,15,14,1,15,14,0,1,0,0,0,15,15,0,0,41,18,23,41,18,23,0,0,0,0,0,0, ,0,1,0,0
1301005003,13,1,5,3,13220,RIVERA,RIVERA,23,21,2,23,21,0,2,0,0,0,21,21,0,0,45,20,25,45,20,25,0,0,0,0,0,0, ,0,1,0,0
1301005004,13,1,5,4,13220,RIVERA,RIVERA,20,16,4,20,16,0,4,0,0,0,16,16,0,0,61,32,29,61,32,29,0,0,0,0,0,0, ,0,1,0,0
1301005005,13,1,5,5,13220,RIVERA,RIVERA,41,38,3,41,38,0,3,0,0,0,40,40,0,0,125,58,67,125,58,67,0,0,0,0,0,0, ,0,1,0,0
1301005006,13,1,5,6,13220,RIVERA,RIVERA,34,31,3,34,31,0,3,0,0,0,32,32,0,0,113,60,53,113,60,53,0,0,0,0,0,0, ,0,1,0,0
1301005007,13,1,5,7,13220,RIVERA,RIVERA,25,25,0,25,25,0,0,0,0,0,25,25,0,0,86,39,47,86,39,47,0,0,0,0,0,0, ,0,1,0,0
1301005008,13,1,5,8,13220,RIVERA,RIVERA,39,37,2,39,37,0,2,0,0,0,37,37,0,0,87,33,54,87,33,54,0,0,0,0,0,0, ,0,1,0,0
1301005009,13,1,5,9,13220,RIVERA,RIVERA,42,39,3,42,39,0,3,0,0,0,39,39,0,0,101,51,50,101,51,50,0,0,0,0,0,0, ,0,1,0,0
1301005010,13,1,5,10,13220,RIVERA,RIVERA,35,30,5,35,30,0,5,0,0,0,31,31,0,0,104,50,54,104,50,54,0,0,0,0,0,0, ,0,1,0,0
1301005011,13,1,5,11,13220,RIVERA,RIVERA,26,24,2,26,24,0,2,0,0,0,24,24,0,0,59,26,33,59,26,33,0,0,0,0,0,0, ,0,1,0,0
1301005012,13,1,5,12,13220,RIVERA,RIVERA,29,29,0,29,29,0,0,0,0,0,29,29,0,0,89,42,47,89,42,47,0,0,0,0,0,0, ,0,1,0,0
1301005013,13,1,5,13,13220,RIVERA,RIVERA,27,27,0,27,27,0,0,0,0,0,29,29,0,0,86,38,48,86,38,48,0,0,0,0,0,0, ,0,1,0,0
1301005014,13,1,5,14,13220,RIVERA,RIVERA,30,28,2,30,28,0,2,0,0,0,28,28,0,0,89,44,45,89,44,45,0,0,0,0,0,0, ,0,1,0,0
1301005015,13,1,5,15,13220,RIVERA,RIVERA,20,18,2,20,18,0,2,0,0,0,20,20,0,0,69,39,30,69,39,30,0,0,0,0,0,0, ,0,1,0,0
1301005016,13,1,5,16,13220,RIVERA,RIVERA,32,25,7,32,25,0,7,0,0,0,25,25,0,0,83,38,45,83,38,45,0,0,0,0,0,0, ,0,1,0,0
1301005017,13,1,5,17,13220,RIVERA,RIVERA,39,36,3,39,36,0,3,0,0,0,36,36,0,0,93,43,50,93,43,50,0,0,0,0,0,0, ,0,1,0,0
1301005018,13,1,5,18,13220,RIVERA,RIVERA,33,29,4,33,29,0,4,0,0,0,30,30,0,0,83,42,41,83,42,41,0,0,0,0,0,0, ,0,1,0,0
1301005019,13,1,5,19,13220,RIVERA,RIVERA,30,29,1,30,29,0,1,0,0,0,31,31,0,0,83,37,46,83,37,46,0,0,0,0,0,0, ,0,1,0,0
1301005020,13,1,5,20,13220,RIVERA,RIVERA,25,21,4,25,21,0,4,0,0,0,22,22,0,0,57,25,32,57,25,32,0,0,0,0,0,0, ,0,1,0,0
1301005021,13,1,5,21,13220,RIVERA,RIVERA,39,34,5,39,34,0,5,0,0,0,35,35,0,0,89,39,50,89,39,50,0,0,0,0,0,0, ,0,1,0,0
1301005022,13,1,5,22,13220,RIVERA,RIVERA,26,23,3,26,23,0,3,0,0,0,23,23,0,0,95,41,54,95,41,54,0,0,0,0,0,0, ,0,1,0,0
1301005023,13,1,5,23,13220,RIVERA,RIVERA,26,22,4,26,22,0,4,0,0,0,22,22,0,0,62,35,27,62,35,27,0,0,0,0,0,0, ,0,1,0,0
1301005024,13,1,5,24,13220,RIVERA,RIVERA,15,12,3,15,12,0,3,0,0,0,12,12,0,0,38,17,21,38,17,21,0,0,0,0,0,0, ,0,1,0,0
1301008001,13,1,8,1,13220,RIVERA,RIVERA,39,33,6,39,33,0,6,0,0,0,33,33,0,0,82,38,44,82,38,44,0,0,0,0,0,0, ,0,1,0,0
1301008002,13,1,8,2,13220,RIVERA,RIVERA,31,29,2,31,29,0,2,0,0,0,29,29,0,0,70,24,46,70,24,46,0,0,0,0,0,0, ,0,1,0,0
1301008003,13,1,8,3,13220,RIVERA,RIVERA,34,31,3,34,31,0,3,0,0,0,31,31,0,0,69,28,41,69,28,41,0,0,0,0,0,0, ,0,1,0,0
1301008004,13,1,8,4,13220,RIVERA,RIVERA,12,9,3,12,9,0,3,0,0,0,9,9,0,0,24,12,12,24,12,12,0,0,0,0,0,0, ,0,1,0,0
1301008005,13,1,8,5,13220,RIVERA,RIVERA,0,0,0,0,0,0,0,0,0,0,0,0,0,0,0,0,0,0,0,0,0,0,0,0,0,0, ,0,1,0,0
1301008006,13,1,8,6,13220,RIVERA,RIVERA,16,13,3,14,11,0,3,2,2,0,13,11,0,2,70,37,33,24,8,16,0,0,0,46,29,17, ,0,1,0,0
1301008007,13,1,8,7,13220,RIVERA,RIVERA,25,16,9,25,16,0,9,0,0,0,16,16,0,0,33,15,18,33,15,18,0,0,0,0,0,0, ,0,1,0,0
1301008008,13,1,8,8,13220,RIVERA,RIVERA,41,38,3,41,38,0,3,0,0,0,38,38,0,0,97,37,60,97,37,60,0,0,0,0,0,0, ,0,1,0,0
1301008009,13,1,8,9,13220,RIVERA,RIVERA,0,0,0,0,0,0,0,0,0,0,0,0,0,0,0,0,0,0,0,0,0,0,0,0,0,0, ,0,1,0,0
1301008010,13,1,8,10,13220,RIVERA,RIVERA,0,0,0,0,0,0,0,0,0,0,0,0,0,0,0,0,0,0,0,0,0,0,0,0,0,0, ,0,1,0,0
1301008011,13,1,8,11,13220,RIVERA,RIVERA,29,23,6,29,23,0,6,0,0,0,24,24,0,0,62,31,31,62,31,31,0,0,0,0,0,0, ,0,1,0,0
1301008012,13,1,8,12,13220,RIVERA,RIVERA,35,27,8,35,27,0,8,0,0,0,27,27,0,0,62,28,34,62,28,34,0,0,0,0,0,0, ,0,1,0,0
1301008013,13,1,8,13,13220,RIVERA,RIVERA,14,14,0,14,14,0,0,0,0,0,14,14,0,0,41,15,26,41,15,26,0,0,0,0,0,0, ,0,1,0,0
1301008014,13,1,8,14,13220,RIVERA,RIVERA,26,21,5,26,21,0,5,0,0,0,21,21,0,0,60,25,35,60,25,35,0,0,0,0,0,0, ,0,1,0,0
1301008015,13,1,8,15,13220,RIVERA,RIVERA,14,10,4,14,10,0,4,0,0,0,11,11,0,0,31,13,18,31,13,18,0,0,0,0,0,0, ,0,1,0,0
1301008016,13,1,8,16,13220,RIVERA,RIVERA,14,11,3,13,10,0,3,1,1,0,11,10,0,1,36,14,22,23,10,13,0,0,0,13,4,9, ,0,1,0,0
1301008017,13,1,8,17,13220,RIVERA,RIVERA,24,23,1,24,23,0,1,0,0,0,23,23,0,0,53,22,31,53,22,31,0,0,0,0,0,0, ,0,1,0,0
1301008018,13,1,8,18,13220,RIVERA,RIVERA,18,17,1,18,17,0,1,0,0,0,17,17,0,0,37,20,17,37,20,17,0,0,0,0,0,0, ,0,1,0,0
1301008019,13,1,8,19,13220,RIVERA,RIVERA,26,23,3,26,23,0,3,0,0,0,23,23,0,0,55,27,28,55,27,28,0,0,0,0,0,0, ,0,1,0,0
1301008020,13,1,8,20,13220,RIVERA,RIVERA,45,37,8,45,37,0,8,0,0,0,37,37,0,0,73,26,47,73,26,47,0,0,0,0,0,0, ,0,1,0,0
1301008021,13,1,8,21,13220,RIVERA,RIVERA,36,29,7,36,29,0,7,0,0,0,29,29,0,0,69,30,39,69,30,39,0,0,0,0,0,0, ,0,1,0,0
1301008023,13,1,8,23,13220,RIVERA,RIVERA,29,26,3,29,26,0,3,0,0,0,26,26,0,0,46,22,24,46,22,24,0,0,0,0,0,0, ,0,1,0,0
1301008024,13,1,8,24,13220,RIVERA,RIVERA,12,10,2,12,10,0,2,0,0,0,10,10,0,0,27,11,16,27,11,16,0,0,0,0,0,0, ,0,1,0,0
1301008025,13,1,8,25,13220,RIVERA,RIVERA,24,17,7,23,17,0,6,1,0,1,17,17,0,0,43,23,20,43,23,20,0,0,0,0,0,0, ,0,1,0,0
1301009004,13,1,9,4,13220,RIVERA,RIVERA,36,22,14,35,22,0,13,1,0,1,22,22,0,0,54,26,28,54,26,28,0,0,0,0,0,0, ,0,1,0,0
1301009005,13,1,9,5,13220,RIVERA,RIVERA,12,9,3,12,9,0,3,0,0,0,10,10,0,0,22,9,13,22,9,13,0,0,0,0,0,0, ,0,1,0,0
1301009006,13,1,9,6,13220,RIVERA,RIVERA,0,0,0,0,0,0,0,0,0,0,0,0,0,0,0,0,0,0,0,0,0,0,0,0,0,0, ,0,1,0,0
1301009009,13,1,9,9,13220,RIVERA,RIVERA,33,30,3,33,30,0,3,0,0,0,32,32,0,0,73,33,40,73,33,40,0,0,0,0,0,0, ,0,1,0,0
1301009010,13,1,9,10,13220,RIVERA,RIVERA,28,24,4,28,24,0,4,0,0,0,26,26,0,0,65,32,33,65,32,33,0,0,0,0,0,0, ,0,1,0,0
1301009011,13,1,9,11,13220,RIVERA,RIVERA,27,25,2,27,25,0,2,0,0,0,25,25,0,0,72,38,34,72,38,34,0,0,0,0,0,0, ,0,1,0,0
1301009013,13,1,9,13,13220,RIVERA,RIVERA,28,19,9,28,19,0,9,0,0,0,19,19,0,0,39,13,26,39,13,26,0,0,0,0,0,0, ,0,1,0,0
1301009014,13,1,9,14,13220,RIVERA,RIVERA,19,15,4,19,15,0,4,0,0,0,15,15,0,0,31,11,20,31,11,20,0,0,0,0,0,0, ,0,1,0,0
1301009018,13,1,9,18,13220,RIVERA,RIVERA,26,26,0,26,26,0,0,0,0,0,26,26,0,0,63,33,30,63,33,30,0,0,0,0,0,0, ,0,1,0,0
1301009019,13,1,9,19,13220,RIVERA,RIVERA,31,25,6,31,25,0,6,0,0,0,25,25,0,0,64,30,34,64,30,34,0,0,0,0,0,0, ,0,1,0,0
1301009022,13,1,9,22,13220,RIVERA,RIVERA,54,51,3,54,51,0,3,0,0,0,56,56,0,0,131,57,74,131,57,74,0,0,0,0,0,0, ,0,1,0,0
1301009025,13,1,9,25,13220,RIVERA,RIVERA,4,3,1,4,3,0,1,0,0,0,3,3,0,0,8,4,4,8,4,4,0,0,0,0,0,0, ,0,9,0,0
1301009027,13,1,9,27,13220,RIVERA,RIVERA,0,0,0,0,0,0,0,0,0,0,0,0,0,0,0,0,0,0,0,0,0,0,0,0,0,0, ,0,1,0,0
1301009028,13,1,9,28,13220,RIVERA,RIVERA,4,1,3,4,1,0,3,0,0,0,1,1,0,0,4,2,2,4,2,2,0,0,0,0,0,0, ,0,9,0,0
1301009031,13,1,9,31,13220,RIVERA,RIVERA,2,2,0,2,2,0,0,0,0,0,2,2,0,0,3,2,1,3,2,1,0,0,0,0,0,0, ,0,1,0,0
1301009033,13,1,9,33,13220,RIVERA,RIVERA,0,0,0,0,0,0,0,0,0,0,0,0,0,0,0,0,0,0,0,0,0,0,0,0,0,0, ,0,1,0,0
1301009401,13,1,9,401,13220,RIVERA,RIVERA,0,0,0,0,0,0,0,0,0,0,0,0,0,0,0,0,0,0,0,0,0,0,0,0,0,0, ,0,1,0,0
1301009402,13,1,9,402,13220,RIVERA,RIVERA,0,0,0,0,0,0,0,0,0,0,0,0,0,0,0,0,0,0,0,0,0,0,0,0,0,0, ,0,1,0,0
1301009403,13,1,9,403,13220,RIVERA,RIVERA,0,0,0,0,0,0,0,0,0,0,0,0,0,0,0,0,0,0,0,0,0,0,0,0,0,0, ,0,1,0,0
1301009404,13,1,9,404,13220,RIVERA,RIVERA,0,0,0,0,0,0,0,0,0,0,0,0,0,0,0,0,0,0,0,0,0,0,0,0,0,0, ,0,1,0,0
1301009405,13,1,9,405,13220,RIVERA,RIVERA,0,0,0,0,0,0,0,0,0,0,0,0,0,0,0,0,0,0,0,0,0,0,0,0,0,0, ,0,1,0,0
1301009406,13,1,9,406,13220,RIVERA,RIVERA,0,0,0,0,0,0,0,0,0,0,0,0,0,0,0,0,0,0,0,0,0,0,0,0,0,0, ,0,1,0,0
1301009407,13,1,9,407,13220,RIVERA,RIVERA,0,0,0,0,0,0,0,0,0,0,0,0,0,0,0,0,0,0,0,0,0,0,0,0,0,0, ,0,1,0,0
1301009408,13,1,9,408,13220,RIVERA,RIVERA,0,0,0,0,0,0,0,0,0,0,0,0,0,0,0,0,0,0,0,0,0,0,0,0,0,0, ,0,1,0,0
1301009409,13,1,9,409,13220,RIVERA,RIVERA,0,0,0,0,0,0,0,0,0,0,0,0,0,0,0,0,0,0,0,0,0,0,0,0,0,0, ,0,1,0,0
1301009410,13,1,9,410,13220,RIVERA,RIVERA,0,0,0,0,0,0,0,0,0,0,0,0,0,0,0,0,0,0,0,0,0,0,0,0,0,0, ,0,1,0,0
1301009411,13,1,9,411,13220,RIVERA,RIVERA,0,0,0,0,0,0,0,0,0,0,0,0,0,0,0,0,0,0,0,0,0,0,0,0,0,0, ,0,1,0,0
1301009600,13,1,9,600,13220,RIVERA,RIVERA,17,15,2,17,15,0,2,0,0,0,18,18,0,0,61,24,37,61,24,37,0,0,0,0,0,0, ,0,1,0,0
1301009601,13,1,9,601,13220,RIVERA,RIVERA,8,8,0,8,8,0,0,0,0,0,8,8,0,0,17,9,8,17,9,8,0,0,0,0,0,0, ,0,1,0,0
1301009602,13,1,9,602,13220,RIVERA,RIVERA,53,52,1,53,52,0,1,0,0,0,59,59,0,0,220,108,112,220,108,112,0,0,0,0,0,0, ,0,1,0,0
1301009603,13,1,9,603,13220,RIVERA,RIVERA,9,9,0,9,9,0,0,0,0,0,9,9,0,0,23,8,15,23,8,15,0,0,0,0,0,0, ,0,1,0,0
1301009604,13,1,9,604,13220,RIVERA,RIVERA,64,59,5,64,59,0,5,0,0,0,59,59,0,0,173,74,99,173,74,99,0,0,0,0,0,0, ,0,1,0,0
1301009801,13,1,9,801,13220,RIVERA,RIVERA,23,21,2,23,21,0,2,0,0,0,21,21,0,0,69,31,38,69,31,38,0,0,0,0,0,0, ,0,1,0,0
1301009802,13,1,9,802,13220,RIVERA,RIVERA,0,0,0,0,0,0,0,0,0,0,0,0,0,0,0,0,0,0,0,0,0,0,0,0,0,0, ,0,1,0,0
1301009803,13,1,9,803,13220,RIVERA,RIVERA,1,1,0,1,1,0,0,0,0,0,1,1,0,0,3,2,1,3,2,1,0,0,0,0,0,0, ,0,1,0,0
1301009804,13,1,9,804,13220,RIVERA,RIVERA,0,0,0,0,0,0,0,0,0,0,0,0,0,0,0,0,0,0,0,0,0,0,0,0,0,0, ,0,1,0,0
1301009805,13,1,9,805,13220,RIVERA,RIVERA,0,0,0,0,0,0,0,0,0,0,0,0,0,0,0,0,0,0,0,0,0,0,0,0,0,0, ,0,1,0,0
1301014001,13,1,14,1,13220,RIVERA,RIVERA,28,22,6,28,22,0,6,0,0,0,23,23,0,0,54,24,30,54,24,30,0,0,0,0,0,0, ,0,1,0,0
1301014002,13,1,14,2,13220,RIVERA,RIVERA,23,21,2,23,21,0,2,0,0,0,21,21,0,0,68,27,41,68,27,41,0,0,0,0,0,0, ,0,1,0,0
1301014003,13,1,14,3,13220,RIVERA,RIVERA,20,17,3,20,17,0,3,0,0,0,17,17,0,0,40,18,22,40,18,22,0,0,0,0,0,0, ,0,1,0,0
1301014004,13,1,14,4,13220,RIVERA,RIVERA,28,22,6,28,22,0,6,0,0,0,22,22,0,0,73,34,39,73,34,39,0,0,0,0,0,0, ,0,1,0,0
1301014005,13,1,14,5,13220,RIVERA,RIVERA,23,18,5,23,18,0,5,0,0,0,18,18,0,0,48,22,26,48,22,26,0,0,0,0,0,0, ,0,1,0,0
1301014006,13,1,14,6,13220,RIVERA,RIVERA,34,28,6,34,28,0,6,0,0,0,28,28,0,0,83,40,43,83,40,43,0,0,0,0,0,0, ,0,1,0,0
1301014007,13,1,14,7,13220,RIVERA,RIVERA,30,25,5,30,25,0,5,0,0,0,26,26,0,0,57,28,29,57,28,29,0,0,0,0,0,0, ,0,1,0,0
1301014008,13,1,14,8,13220,RIVERA,RIVERA,28,27,1,28,27,0,1,0,0,0,27,27,0,0,81,37,44,81,37,44,0,0,0,0,0,0, ,0,1,0,0
1301014009,13,1,14,9,13220,RIVERA,RIVERA,24,21,3,24,21,0,3,0,0,0,22,22,0,0,52,30,22,52,30,22,0,0,0,0,0,0, ,0,1,0,0
1301014010,13,1,14,10,13220,RIVERA,RIVERA,14,14,0,14,14,0,0,0,0,0,15,15,0,0,42,24,18,42,24,18,0,0,0,0,0,0, ,0,1,0,0
1301014011,13,1,14,11,13220,RIVERA,RIVERA,32,29,3,32,29,0,3,0,0,0,29,29,0,0,85,42,43,85,42,43,0,0,0,0,0,0, ,0,1,0,0
1301014012,13,1,14,12,13220,RIVERA,RIVERA,1,1,0,1,1,0,0,0,0,0,1,1,0,0,4,4,0,4,4,0,0,0,0,0,0,0, ,0,1,0,0
1301014013,13,1,14,13,13220,RIVERA,RIVERA,53,49,4,53,49,0,4,0,0,0,50,50,0,0,154,79,75,154,79,75,0,0,0,0,0,0, ,0,1,0,0
1301014015,13,1,14,15,13220,RIVERA,RIVERA,0,0,0,0,0,0,0,0,0,0,0,0,0,0,0,0,0,0,0,0,0,0,0,0,0,0, ,0,1,0,0
1301014016,13,1,14,16,13220,RIVERA,RIVERA,30,28,2,30,28,0,2,0,0,0,29,29,0,0,78,38,40,78,38,40,0,0,0,0,0,0, ,0,1,0,0
1301014017,13,1,14,17,13220,RIVERA,RIVERA,28,27,1,28,27,0,1,0,0,0,27,27,0,0,64,25,39,64,25,39,0,0,0,0,0,0, ,0,1,0,0
1301014018,13,1,14,18,13220,RIVERA,RIVERA,28,28,0,28,28,0,0,0,0,0,28,28,0,0,81,31,50,81,31,50,0,0,0,0,0,0, ,0,1,0,0
1301014019,13,1,14,19,13220,RIVERA,RIVERA,81,74,7,81,74,0,7,0,0,0,76,76,0,0,202,95,107,202,95,107,0,0,0,0,0,0, ,0,1,0,0
1301014020,13,1,14,20,13220,RIVERA,RIVERA,36,30,6,36,30,0,6,0,0,0,30,30,0,0,82,36,46,82,36,46,0,0,0,0,0,0, ,0,1,0,0
1301014021,13,1,14,21,13220,RIVERA,RIVERA,60,54,6,60,54,0,6,0,0,0,54,54,0,0,150,71,79,150,71,79,0,0,0,0,0,0, ,0,1,0,0
1301014022,13,1,14,22,13220,RIVERA,RIVERA,34,33,1,34,33,0,1,0,0,0,35,35,0,0,94,45,49,94,45,49,0,0,0,0,0,0, ,0,1,0,0
1301014023,13,1,14,23,13220,RIVERA,RIVERA,25,19,6,25,19,0,6,0,0,0,22,22,0,0,54,24,30,54,24,30,0,0,0,0,0,0, ,0,1,0,0
1301014400,13,1,14,400,13220,RIVERA,RIVERA,0,0,0,0,0,0,0,0,0,0,0,0,0,0,0,0,0,0,0,0,0,0,0,0,0,0, ,0,9,0,0
1301014401,13,1,14,401,13220,RIVERA,RIVERA,0,0,0,0,0,0,0,0,0,0,0,0,0,0,0,0,0,0,0,0,0,0,0,0,0,0, ,0,9,0,0
1301014402,13,1,14,402,13220,RIVERA,RIVERA,0,0,0,0,0,0,0,0,0,0,0,0,0,0,0,0,0,0,0,0,0,0,0,0,0,0, ,0,1,0,0
1301014403,13,1,14,403,13220,RIVERA,RIVERA,0,0,0,0,0,0,0,0,0,0,0,0,0,0,0,0,0,0,0,0,0,0,0,0,0,0, ,0,1,0,0
1301014404,13,1,14,404,13220,RIVERA,RIVERA,0,0,0,0,0,0,0,0,0,0,0,0,0,0,0,0,0,0,0,0,0,0,0,0,0,0, ,0,9,0,0
1301014405,13,1,14,405,13220,RIVERA,RIVERA,0,0,0,0,0,0,0,0,0,0,0,0,0,0,0,0,0,0,0,0,0,0,0,0,0,0, ,0,1,0,0
1301014406,13,1,14,406,13220,RIVERA,RIVERA,0,0,0,0,0,0,0,0,0,0,0,0,0,0,0,0,0,0,0,0,0,0,0,0,0,0, ,0,1,0,0
1301014407,13,1,14,407,13220,RIVERA,RIVERA,0,0,0,0,0,0,0,0,0,0,0,0,0,0,0,0,0,0,0,0,0,0,0,0,0,0, ,0,1,0,0
1301014408,13,1,14,408,13220,RIVERA,RIVERA,0,0,0,0,0,0,0,0,0,0,0,0,0,0,0,0,0,0,0,0,0,0,0,0,0,0, ,0,1,0,0
1301014409,13,1,14,409,13220,RIVERA,RIVERA,0,0,0,0,0,0,0,0,0,0,0,0,0,0,0,0,0,0,0,0,0,0,0,0,0,0, ,0,9,0,0
1301014410,13,1,14,410,13220,RIVERA,RIVERA,0,0,0,0,0,0,0,0,0,0,0,0,0,0,0,0,0,0,0,0,0,0,0,0,0,0, ,0,1,0,0
1301014411,13,1,14,411,13220,RIVERA,RIVERA,0,0,0,0,0,0,0,0,0,0,0,0,0,0,0,0,0,0,0,0,0,0,0,0,0,0, ,0,9,0,0
1301014412,13,1,14,412,13220,RIVERA,RIVERA,0,0,0,0,0,0,0,0,0,0,0,0,0,0,0,0,0,0,0,0,0,0,0,0,0,0, ,0,1,0,0
1301014413,13,1,14,413,13220,RIVERA,RIVERA,0,0,0,0,0,0,0,0,0,0,0,0,0,0,0,0,0,0,0,0,0,0,0,0,0,0, ,0,9,0,0
1301014414,13,1,14,414,13220,RIVERA,RIVERA,0,0,0,0,0,0,0,0,0,0,0,0,0,0,0,0,0,0,0,0,0,0,0,0,0,0, ,0,1,0,0
1301014415,13,1,14,415,13220,RIVERA,RIVERA,0,0,0,0,0,0,0,0,0,0,0,0,0,0,0,0,0,0,0,0,0,0,0,0,0,0, ,0,1,0,0
1301014416,13,1,14,416,13220,RIVERA,RIVERA,0,0,0,0,0,0,0,0,0,0,0,0,0,0,0,0,0,0,0,0,0,0,0,0,0,0, ,0,1,0,0
1301014417,13,1,14,417,13220,RIVERA,RIVERA,0,0,0,0,0,0,0,0,0,0,0,0,0,0,0,0,0,0,0,0,0,0,0,0,0,0, ,0,1,0,0
1301014600,13,1,14,600,13220,RIVERA,RIVERA,41,38,3,41,38,0,3,0,0,0,39,39,0,0,107,52,55,107,52,55,0,0,0,0,0,0, ,0,1,0,0
1301017001,13,1,17,1,13220,RIVERA,RIVERA,29,27,2,29,27,0,2,0,0,0,28,28,0,0,77,33,44,77,33,44,0,0,0,0,0,0, ,0,1,0,0
1301017002,13,1,17,2,13220,RIVERA,RIVERA,21,19,2,21,19,0,2,0,0,0,19,19,0,0,52,26,26,52,26,26,0,0,0,0,0,0, ,0,1,0,0
1301017003,13,1,17,3,13220,RIVERA,RIVERA,24,22,2,24,22,0,2,0,0,0,25,25,0,0,66,32,34,66,32,34,0,0,0,0,0,0, ,0,1,0,0
1301017004,13,1,17,4,13220,RIVERA,RIVERA,14,14,0,14,14,0,0,0,0,0,15,15,0,0,38,18,20,38,18,20,0,0,0,0,0,0, ,0,1,0,0
1301017005,13,1,17,5,13220,RIVERA,RIVERA,31,27,4,31,27,0,4,0,0,0,27,27,0,0,70,34,36,70,34,36,0,0,0,0,0,0, ,0,1,0,0
1301017006,13,1,17,6,13220,RIVERA,RIVERA,27,26,1,27,26,0,1,0,0,0,26,26,0,0,67,27,40,67,27,40,0,0,0,0,0,0, ,0,1,0,0
1301017007,13,1,17,7,13220,RIVERA,RIVERA,50,41,9,50,41,0,9,0,0,0,43,43,0,0,94,43,51,94,43,51,0,0,0,0,0,0, ,0,1,0,0
1301017008,13,1,17,8,13220,RIVERA,RIVERA,38,35,3,38,35,0,3,0,0,0,36,36,0,0,95,39,56,95,39,56,0,0,0,0,0,0, ,0,1,0,0
1301017009,13,1,17,9,13220,RIVERA,RIVERA,33,29,4,33,29,0,4,0,0,0,29,29,0,0,82,38,44,82,38,44,0,0,0,0,0,0, ,0,1,0,0
1301017010,13,1,17,10,13220,RIVERA,RIVERA,27,22,5,27,22,0,5,0,0,0,22,22,0,0,56,27,29,56,27,29,0,0,0,0,0,0, ,0,1,0,0
1301017011,13,1,17,11,13220,RIVERA,RIVERA,33,31,2,33,31,0,2,0,0,0,31,31,0,0,97,44,53,97,44,53,0,0,0,0,0,0, ,0,1,0,0
1301017012,13,1,17,12,13220,RIVERA,RIVERA,38,32,6,38,32,0,6,0,0,0,32,32,0,0,66,34,32,66,34,32,0,0,0,0,0,0, ,0,1,0,0
1301017013,13,1,17,13,13220,RIVERA,RIVERA,28,23,5,27,23,0,4,1,0,1,23,23,0,0,55,25,30,55,25,30,0,0,0,0,0,0, ,0,1,0,0
1301017014,13,1,17,14,13220,RIVERA,RIVERA,30,21,9,30,21,0,9,0,0,0,21,21,0,0,63,31,32,63,31,32,0,0,0,0,0,0, ,0,1,0,0
1301017015,13,1,17,15,13220,RIVERA,RIVERA,22,21,1,22,21,0,1,0,0,0,21,21,0,0,46,21,25,46,21,25,0,0,0,0,0,0, ,0,1,0,0
1301017016,13,1,17,16,13220,RIVERA,RIVERA,34,34,0,33,33,0,0,1,1,0,35,35,0,0,80,40,40,80,40,40,0,0,0,0,0,0, ,0,1,0,0
1301017017,13,1,17,17,13220,RIVERA,RIVERA,33,32,1,33,32,0,1,0,0,0,32,32,0,0,70,35,35,70,35,35,0,0,0,0,0,0, ,0,1,0,0
1301017018,13,1,17,18,13220,RIVERA,RIVERA,41,37,4,41,37,0,4,0,0,0,37,37,0,0,105,49,56,105,49,56,0,0,0,0,0,0, ,0,1,0,0
1301018001,13,1,18,1,13220,RIVERA,RIVERA,36,31,5,36,31,0,5,0,0,0,31,31,0,0,86,40,46,86,40,46,0,0,0,0,0,0, ,0,1,0,0
1301018002,13,1,18,2,13220,RIVERA,RIVERA,28,22,6,28,22,0,6,0,0,0,22,22,0,0,56,24,32,56,24,32,0,0,0,0,0,0, ,0,1,0,0
1301018003,13,1,18,3,13220,RIVERA,RIVERA,41,37,4,41,37,0,4,0,0,0,37,37,0,0,108,49,59,108,49,59,0,0,0,0,0,0, ,0,1,0,0
1301018004,13,1,18,4,13220,RIVERA,RIVERA,34,33,1,34,33,0,1,0,0,0,35,35,0,0,99,44,55,99,44,55,0,0,0,0,0,0, ,0,1,0,0
1301018005,13,1,18,5,13220,RIVERA,RIVERA,31,28,3,31,28,0,3,0,0,0,28,28,0,0,95,51,44,95,51,44,0,0,0,0,0,0, ,0,1,0,0
1301018006,13,1,18,6,13220,RIVERA,RIVERA,22,17,5,22,17,0,5,0,0,0,17,17,0,0,38,17,21,38,17,21,0,0,0,0,0,0, ,0,1,0,0
1301018007,13,1,18,7,13220,RIVERA,RIVERA,33,27,6,33,27,0,6,0,0,0,28,28,0,0,84,39,45,84,39,45,0,0,0,0,0,0, ,0,1,0,0
1301018008,13,1,18,8,13220,RIVERA,RIVERA,24,19,5,24,19,0,5,0,0,0,19,19,0,0,63,26,37,63,26,37,0,0,0,0,0,0, ,0,1,0,0
1301018009,13,1,18,9,13220,RIVERA,RIVERA,31,31,0,31,31,0,0,0,0,0,31,31,0,0,95,42,53,95,42,53,0,0,0,0,0,0, ,0,1,0,0
1301018010,13,1,18,10,13220,RIVERA,RIVERA,31,29,2,31,29,0,2,0,0,0,29,29,0,0,88,42,46,88,42,46,0,0,0,0,0,0, ,0,1,0,0
1301018011,13,1,18,11,13220,RIVERA,RIVERA,29,24,5,29,24,0,5,0,0,0,27,27,0,0,90,41,49,90,41,49,0,0,0,0,0,0, ,0,1,0,0
1301018012,13,1,18,12,13220,RIVERA,RIVERA,45,38,7,45,38,0,7,0,0,0,38,38,0,0,105,46,59,105,46,59,0,0,0,0,0,0, ,0,1,0,0
1301018013,13,1,18,13,13220,RIVERA,RIVERA,21,19,2,21,19,0,2,0,0,0,19,19,0,0,53,25,28,53,25,28,0,0,0,0,0,0, ,0,1,0,0
1301018014,13,1,18,14,13220,RIVERA,RIVERA,11,11,0,11,11,0,0,0,0,0,11,11,0,0,42,23,19,42,23,19,0,0,0,0,0,0, ,0,1,0,0
1301018015,13,1,18,15,13220,RIVERA,RIVERA,53,48,5,53,48,0,5,0,0,0,49,49,0,0,154,74,80,154,74,80,0,0,0,0,0,0, ,0,1,0,0
1301018016,13,1,18,16,13220,RIVERA,RIVERA,43,41,2,43,41,0,2,0,0,0,43,43,0,0,131,61,70,131,61,70,0,0,0,0,0,0, ,0,1,0,0
1301018017,13,1,18,17,13220,RIVERA,RIVERA,44,39,5,44,39,0,5,0,0,0,40,40,0,0,132,68,64,132,68,64,0,0,0,0,0,0, ,0,1,0,0
1301018018,13,1,18,18,13220,RIVERA,RIVERA,38,34,4,38,34,0,4,0,0,0,34,34,0,0,99,46,53,99,46,53,0,0,0,0,0,0, ,0,1,0,0
1301018019,13,1,18,19,13220,RIVERA,RIVERA,24,23,1,24,23,0,1,0,0,0,23,23,0,0,71,38,33,71,38,33,0,0,0,0,0,0, ,0,1,0,0
1301018020,13,1,18,20,13220,RIVERA,RIVERA,31,29,2,31,29,0,2,0,0,0,30,30,0,0,98,44,54,98,44,54,0,0,0,0,0,0, ,0,1,0,0
1301018401,13,1,18,401,13220,RIVERA,RIVERA,0,0,0,0,0,0,0,0,0,0,0,0,0,0,0,0,0,0,0,0,0,0,0,0,0,0, ,0,1,0,0
1301018402,13,1,18,402,13220,RIVERA,RIVERA,0,0,0,0,0,0,0,0,0,0,0,0,0,0,0,0,0,0,0,0,0,0,0,0,0,0, ,0,1,0,0
1301018403,13,1,18,403,13220,RIVERA,RIVERA,0,0,0,0,0,0,0,0,0,0,0,0,0,0,0,0,0,0,0,0,0,0,0,0,0,0, ,0,1,0,0
1301018404,13,1,18,404,13220,RIVERA,RIVERA,0,0,0,0,0,0,0,0,0,0,0,0,0,0,0,0,0,0,0,0,0,0,0,0,0,0, ,0,1,0,0
1301018405,13,1,18,405,13220,RIVERA,RIVERA,0,0,0,0,0,0,0,0,0,0,0,0,0,0,0,0,0,0,0,0,0,0,0,0,0,0, ,0,1,0,0
1301018600,13,1,18,600,13220,RIVERA,RIVERA,0,0,0,0,0,0,0,0,0,0,0,0,0,0,0,0,0,0,0,0,0,0,0,0,0,0, ,0,1,0,0
1301020001,13,1,20,1,13220,RIVERA,RIVERA,21,21,0,21,21,0,0,0,0,0,22,22,0,0,53,22,31,53,22,31,0,0,0,0,0,0, ,0,1,0,0
1301020002,13,1,20,2,13220,RIVERA,RIVERA,20,18,2,20,18,0,2,0,0,0,18,18,0,0,50,21,29,50,21,29,0,0,0,0,0,0, ,0,1,0,0
1301020003,13,1,20,3,13220,RIVERA,RIVERA,0,0,0,0,0,0,0,0,0,0,0,0,0,0,0,0,0,0,0,0,0,0,0,0,0,0, ,0,1,0,0
1301020004,13,1,20,4,13220,RIVERA,RIVERA,19,17,2,19,17,0,2,0,0,0,17,17,0,0,60,25,35,60,25,35,0,0,0,0,0,0, ,0,1,0,0
1301020005,13,1,20,5,13220,RIVERA,RIVERA,22,19,3,22,19,0,3,0,0,0,21,21,0,0,46,23,23,46,23,23,0,0,0,0,0,0, ,0,1,0,0
1301020006,13,1,20,6,13220,RIVERA,RIVERA,27,22,5,27,22,0,5,0,0,0,22,22,0,0,62,27,35,62,27,35,0,0,0,0,0,0, ,0,1,0,0
1301020007,13,1,20,7,13220,RIVERA,RIVERA,21,16,5,21,16,0,5,0,0,0,16,16,0,0,31,15,16,31,15,16,0,0,0,0,0,0, ,0,1,0,0
1301020008,13,1,20,8,13220,RIVERA,RIVERA,102,82,20,102,82,0,20,0,0,0,83,83,0,0,204,88,116,204,88,116,0,0,0,0,0,0, ,0,1,0,0
1301020009,13,1,20,9,13220,RIVERA,RIVERA,26,18,8,26,18,0,8,0,0,0,18,18,0,0,44,22,22,44,22,22,0,0,0,0,0,0, ,0,1,0,0
1301020010,13,1,20,10,13220,RIVERA,RIVERA,28,22,6,28,22,0,6,0,0,0,22,22,0,0,70,35,35,70,35,35,0,0,0,0,0,0, ,0,1,0,0
1301020011,13,1,20,11,13220,RIVERA,RIVERA,0,0,0,0,0,0,0,0,0,0,0,0,0,0,0,0,0,0,0,0,0,0,0,0,0,0, ,0,9,0,0
1301020401,13,1,20,401,13220,RIVERA,RIVERA,0,0,0,0,0,0,0,0,0,0,0,0,0,0,0,0,0,0,0,0,0,0,0,0,0,0, ,0,1,0,0
1301020402,13,1,20,402,13220,RIVERA,RIVERA,0,0,0,0,0,0,0,0,0,0,0,0,0,0,0,0,0,0,0,0,0,0,0,0,0,0, ,0,1,0,0
1301020403,13,1,20,403,13220,RIVERA,RIVERA,0,0,0,0,0,0,0,0,0,0,0,0,0,0,0,0,0,0,0,0,0,0,0,0,0,0, ,0,1,0,0
1301020404,13,1,20,404,13220,RIVERA,RIVERA,0,0,0,0,0,0,0,0,0,0,0,0,0,0,0,0,0,0,0,0,0,0,0,0,0,0, ,0,9,0,0
1301020405,13,1,20,405,13220,RIVERA,RIVERA,0,0,0,0,0,0,0,0,0,0,0,0,0,0,0,0,0,0,0,0,0,0,0,0,0,0, ,0,9,0,0
1301020406,13,1,20,406,13220,RIVERA,RIVERA,0,0,0,0,0,0,0,0,0,0,0,0,0,0,0,0,0,0,0,0,0,0,0,0,0,0, ,0,9,0,0
1301020407,13,1,20,407,13220,RIVERA,RIVERA,0,0,0,0,0,0,0,0,0,0,0,0,0,0,0,0,0,0,0,0,0,0,0,0,0,0, ,0,9,0,0
1301020408,13,1,20,408,13220,RIVERA,RIVERA,0,0,0,0,0,0,0,0,0,0,0,0,0,0,0,0,0,0,0,0,0,0,0,0,0,0, ,0,1,0,0
1301020409,13,1,20,409,13220,RIVERA,RIVERA,0,0,0,0,0,0,0,0,0,0,0,0,0,0,0,0,0,0,0,0,0,0,0,0,0,0, ,0,9,0,0
1301020411,13,1,20,411,13220,RIVERA,RIVERA,0,0,0,0,0,0,0,0,0,0,0,0,0,0,0,0,0,0,0,0,0,0,0,0,0,0, ,0,9,0,0
1301020412,13,1,20,412,13220,RIVERA,RIVERA,0,0,0,0,0,0,0,0,0,0,0,0,0,0,0,0,0,0,0,0,0,0,0,0,0,0, ,0,9,0,0
1301020413,13,1,20,413,13220,RIVERA,RIVERA,0,0,0,0,0,0,0,0,0,0,0,0,0,0,0,0,0,0,0,0,0,0,0,0,0,0, ,0,1,0,0
1301020414,13,1,20,414,13220,RIVERA,RIVERA,0,0,0,0,0,0,0,0,0,0,0,0,0,0,0,0,0,0,0,0,0,0,0,0,0,0, ,0,9,0,0
1301020415,13,1,20,415,13220,RIVERA,RIVERA,0,0,0,0,0,0,0,0,0,0,0,0,0,0,0,0,0,0,0,0,0,0,0,0,0,0, ,0,1,0,0
1301020416,13,1,20,416,13220,RIVERA,RIVERA,0,0,0,0,0,0,0,0,0,0,0,0,0,0,0,0,0,0,0,0,0,0,0,0,0,0, ,0,1,0,0
1301020417,13,1,20,417,13220,RIVERA,RIVERA,0,0,0,0,0,0,0,0,0,0,0,0,0,0,0,0,0,0,0,0,0,0,0,0,0,0, ,0,1,0,0
1301020418,13,1,20,418,13220,RIVERA,RIVERA,0,0,0,0,0,0,0,0,0,0,0,0,0,0,0,0,0,0,0,0,0,0,0,0,0,0, ,0,1,0,0
1301020600,13,1,20,600,13220,RIVERA,RIVERA,0,0,0,0,0,0,0,0,0,0,0,0,0,0,0,0,0,0,0,0,0,0,0,0,0,0, ,0,9,0,0
1301020601,13,1,20,601,13220,RIVERA,RIVERA,98,94,4,98,94,0,4,0,0,0,94,94,0,0,242,112,130,242,112,130,0,0,0,0,0,0, ,0,9,0,0
1301021001,13,1,21,1,13220,RIVERA,RIVERA,27,26,1,27,26,0,1,0,0,0,26,26,0,0,82,40,42,82,40,42,0,0,0,0,0,0, ,0,1,0,0
1301021002,13,1,21,2,13220,RIVERA,RIVERA,33,30,3,33,30,0,3,0,0,0,30,30,0,0,91,45,46,91,45,46,0,0,0,0,0,0, ,0,1,0,0
1301021003,13,1,21,3,13220,RIVERA,RIVERA,29,26,3,29,26,0,3,0,0,0,26,26,0,0,75,37,38,75,37,38,0,0,0,0,0,0, ,0,1,0,0
1301021004,13,1,21,4,13220,RIVERA,RIVERA,32,28,4,32,28,0,4,0,0,0,28,28,0,0,89,47,42,89,47,42,0,0,0,0,0,0, ,0,1,0,0
1301021005,13,1,21,5,13220,RIVERA,RIVERA,30,27,3,30,27,0,3,0,0,0,27,27,0,0,85,35,50,85,35,50,0,0,0,0,0,0, ,0,1,0,0
1301021006,13,1,21,6,13220,RIVERA,RIVERA,30,25,5,30,25,0,5,0,0,0,25,25,0,0,63,28,35,63,28,35,0,0,0,0,0,0, ,0,1,0,0
1301021007,13,1,21,7,13220,RIVERA,RIVERA,32,31,1,32,31,0,1,0,0,0,31,31,0,0,82,32,50,82,32,50,0,0,0,0,0,0, ,0,1,0,0
1301021008,13,1,21,8,13220,RIVERA,RIVERA,28,24,4,28,24,0,4,0,0,0,24,24,0,0,78,36,42,78,36,42,0,0,0,0,0,0, ,0,1,0,0
1301021009,13,1,21,9,13220,RIVERA,RIVERA,26,25,1,26,25,0,1,0,0,0,26,26,0,0,71,37,34,71,37,34,0,0,0,0,0,0, ,0,1,0,0
1301021010,13,1,21,10,13220,RIVERA,RIVERA,34,31,3,34,31,0,3,0,0,0,32,32,0,0,98,44,54,98,44,54,0,0,0,0,0,0, ,0,1,0,0
1301021011,13,1,21,11,13220,RIVERA,RIVERA,31,30,1,31,30,0,1,0,0,0,30,30,0,0,84,42,42,84,42,42,0,0,0,0,0,0, ,0,1,0,0
1301021012,13,1,21,12,13220,RIVERA,RIVERA,40,35,5,40,35,0,5,0,0,0,35,35,0,0,83,38,45,83,38,45,0,0,0,0,0,0, ,0,1,0,0
1301021013,13,1,21,13,13220,RIVERA,RIVERA,36,35,1,36,35,0,1,0,0,0,35,35,0,0,90,43,47,90,43,47,0,0,0,0,0,0, ,0,1,0,0
1301021014,13,1,21,14,13220,RIVERA,RIVERA,31,28,3,31,28,0,3,0,0,0,28,28,0,0,69,34,35,69,34,35,0,0,0,0,0,0, ,0,1,0,0
1301021015,13,1,21,15,13220,RIVERA,RIVERA,23,23,0,23,23,0,0,0,0,0,23,23,0,0,65,33,32,65,33,32,0,0,0,0,0,0, ,0,1,0,0
1301021016,13,1,21,16,13220,RIVERA,RIVERA,31,27,4,31,27,0,4,0,0,0,30,30,0,0,70,30,40,70,30,40,0,0,0,0,0,0, ,0,1,0,0
1301021017,13,1,21,17,13220,RIVERA,RIVERA,33,30,3,33,30,0,3,0,0,0,30,30,0,0,77,31,46,77,31,46,0,0,0,0,0,0, ,0,1,0,0
1301021018,13,1,21,18,13220,RIVERA,RIVERA,40,35,5,40,35,0,5,0,0,0,35,35,0,0,72,25,47,72,25,47,0,0,0,0,0,0, ,0,1,0,0
1301021019,13,1,21,19,13220,RIVERA,RIVERA,31,31,0,31,31,0,0,0,0,0,31,31,0,0,71,28,43,71,28,43,0,0,0,0,0,0, ,0,1,0,0
1301021020,13,1,21,20,13220,RIVERA,RIVERA,33,31,2,33,31,0,2,0,0,0,31,31,0,0,87,37,50,87,37,50,0,0,0,0,0,0, ,0,1,0,0
1301101001,13,1,101,1,13220,RIVERA,RIVERA,50,44,6,50,44,0,6,0,0,0,46,46,0,0,153,79,74,153,79,74,0,0,0,0,0,0, ,0,1,0,0
1301101002,13,1,101,2,13220,RIVERA,RIVERA,36,36,0,36,36,0,0,0,0,0,37,37,0,0,113,59,54,113,59,54,0,0,0,0,0,0, ,0,1,0,0
1301101003,13,1,101,3,13220,RIVERA,RIVERA,18,18,0,18,18,0,0,0,0,0,18,18,0,0,50,21,29,50,21,29,0,0,0,0,0,0, ,0,1,0,0
1301101004,13,1,101,4,13220,RIVERA,RIVERA,20,20,0,20,20,0,0,0,0,0,20,20,0,0,67,32,35,67,32,35,0,0,0,0,0,0, ,0,1,0,0
1301101005,13,1,101,5,13220,RIVERA,RIVERA,9,9,0,9,9,0,0,0,0,0,9,9,0,0,23,11,12,23,11,12,0,0,0,0,0,0, ,0,1,0,0
1301101007,13,1,101,7,13220,RIVERA,RIVERA,14,14,0,14,14,0,0,0,0,0,14,14,0,0,49,20,29,49,20,29,0,0,0,0,0,0, ,0,1,0,0
1301101008,13,1,101,8,13220,RIVERA,RIVERA,24,22,2,24,22,0,2,0,0,0,22,22,0,0,77,34,43,77,34,43,0,0,0,0,0,0, ,0,1,0,0
1301101009,13,1,101,9,13220,RIVERA,RIVERA,22,21,1,22,21,0,1,0,0,0,21,21,0,0,57,29,28,57,29,28,0,0,0,0,0,0, ,0,1,0,0
1301101010,13,1,101,10,13220,RIVERA,RIVERA,30,27,3,30,27,0,3,0,0,0,27,27,0,0,93,42,51,93,42,51,0,0,0,0,0,0, ,0,1,0,0
1301101011,13,1,101,11,13220,RIVERA,RIVERA,23,20,3,23,20,0,3,0,0,0,20,20,0,0,45,21,24,45,21,24,0,0,0,0,0,0, ,0,1,0,0
1301101012,13,1,101,12,13220,RIVERA,RIVERA,31,31,0,31,31,0,0,0,0,0,31,31,0,0,94,44,50,94,44,50,0,0,0,0,0,0, ,0,1,0,0
1301101013,13,1,101,13,13220,RIVERA,RIVERA,20,20,0,20,20,0,0,0,0,0,20,20,0,0,49,25,24,49,25,24,0,0,0,0,0,0, ,0,1,0,0
1301101023,13,1,101,23,13220,RIVERA,RIVERA,18,17,1,18,17,0,1,0,0,0,20,20,0,0,65,31,34,65,31,34,0,0,0,0,0,0, ,0,1,0,0
1301101024,13,1,101,24,13220,RIVERA,RIVERA,34,29,5,34,29,0,5,0,0,0,29,29,0,0,93,38,55,93,38,55,0,0,0,0,0,0, ,0,1,0,0
1301101401,13,1,101,401,13220,RIVERA,RIVERA,0,0,0,0,0,0,0,0,0,0,0,0,0,0,0,0,0,0,0,0,0,0,0,0,0,0, ,0,1,0,0
1301101402,13,1,101,402,13220,RIVERA,RIVERA,0,0,0,0,0,0,0,0,0,0,0,0,0,0,0,0,0,0,0,0,0,0,0,0,0,0, ,0,1,0,0
1301101403,13,1,101,403,13220,RIVERA,RIVERA,0,0,0,0,0,0,0,0,0,0,0,0,0,0,0,0,0,0,0,0,0,0,0,0,0,0, ,0,1,0,0
1301101405,13,1,101,405,13220,RIVERA,RIVERA,0,0,0,0,0,0,0,0,0,0,0,0,0,0,0,0,0,0,0,0,0,0,0,0,0,0, ,0,1,0,0
1301101406,13,1,101,406,13220,RIVERA,RIVERA,0,0,0,0,0,0,0,0,0,0,0,0,0,0,0,0,0,0,0,0,0,0,0,0,0,0, ,0,1,0,0
1301101407,13,1,101,407,13220,RIVERA,RIVERA,0,0,0,0,0,0,0,0,0,0,0,0,0,0,0,0,0,0,0,0,0,0,0,0,0,0, ,0,1,0,0
1301101408,13,1,101,408,13220,RIVERA,RIVERA,0,0,0,0,0,0,0,0,0,0,0,0,0,0,0,0,0,0,0,0,0,0,0,0,0,0, ,0,1,0,0
1301101409,13,1,101,409,13220,RIVERA,RIVERA,0,0,0,0,0,0,0,0,0,0,0,0,0,0,0,0,0,0,0,0,0,0,0,0,0,0, ,0,1,0,0
1301101410,13,1,101,410,13220,RIVERA,RIVERA,0,0,0,0,0,0,0,0,0,0,0,0,0,0,0,0,0,0,0,0,0,0,0,0,0,0, ,0,1,0,0
1301101411,13,1,101,411,13220,RIVERA,RIVERA,0,0,0,0,0,0,0,0,0,0,0,0,0,0,0,0,0,0,0,0,0,0,0,0,0,0, ,0,1,0,0
1301101600,13,1,101,600,13220,RIVERA,RIVERA,21,21,0,21,21,0,0,0,0,0,22,22,0,0,70,35,35,70,35,35,0,0,0,0,0,0, ,0,1,0,0
1301101601,13,1,101,601,13220,RIVERA,RIVERA,24,24,0,24,24,0,0,0,0,0,25,25,0,0,64,30,34,64,30,34,0,0,0,0,0,0, ,0,1,0,0
1301101602,13,1,101,602,13220,RIVERA,RIVERA,27,27,0,27,27,0,0,0,0,0,27,27,0,0,104,52,52,104,52,52,0,0,0,0,0,0, ,0,1,0,0
1301101603,13,1,101,603,13220,RIVERA,RIVERA,10,5,5,10,5,0,5,0,0,0,5,5,0,0,11,6,5,11,6,5,0,0,0,0,0,0, ,0,1,0,0
1301102002,13,1,102,2,13220,RIVERA,RIVERA,38,34,4,38,34,0,4,0,0,0,34,34,0,0,99,45,54,99,45,54,0,0,0,0,0,0, ,0,1,0,0
1301102003,13,1,102,3,13220,RIVERA,RIVERA,29,29,0,29,29,0,0,0,0,0,29,29,0,0,101,44,57,101,44,57,0,0,0,0,0,0, ,0,1,0,0
1301102004,13,1,102,4,13220,RIVERA,RIVERA,27,27,0,27,27,0,0,0,0,0,27,27,0,0,85,45,40,85,45,40,0,0,0,0,0,0, ,0,1,0,0
1301102005,13,1,102,5,13220,RIVERA,RIVERA,41,34,7,41,34,0,7,0,0,0,34,34,0,0,93,49,44,93,49,44,0,0,0,0,0,0, ,0,1,0,0
1301102006,13,1,102,6,13220,RIVERA,RIVERA,30,27,3,30,27,0,3,0,0,0,27,27,0,0,73,32,41,73,32,41,0,0,0,0,0,0, ,0,1,0,0
1301102007,13,1,102,7,13220,RIVERA,RIVERA,18,17,1,18,17,0,1,0,0,0,17,17,0,0,43,21,22,43,21,22,0,0,0,0,0,0, ,0,1,0,0
1301102008,13,1,102,8,13220,RIVERA,RIVERA,0,0,0,0,0,0,0,0,0,0,0,0,0,0,0,0,0,0,0,0,0,0,0,0,0,0, ,0,1,0,0
1301102009,13,1,102,9,13220,RIVERA,RIVERA,24,22,2,24,22,0,2,0,0,0,22,22,0,0,58,21,37,58,21,37,0,0,0,0,0,0, ,0,1,0,0
1301102010,13,1,102,10,13220,RIVERA,RIVERA,30,27,3,30,27,0,3,0,0,0,27,27,0,0,87,42,45,87,42,45,0,0,0,0,0,0, ,0,1,0,0
1301102011,13,1,102,11,13220,RIVERA,RIVERA,25,23,2,25,23,0,2,0,0,0,23,23,0,0,60,31,29,60,31,29,0,0,0,0,0,0, ,0,1,0,0
1301102012,13,1,102,12,13220,RIVERA,RIVERA,26,23,3,26,23,0,3,0,0,0,23,23,0,0,58,27,31,58,27,31,0,0,0,0,0,0, ,0,1,0,0
1301102013,13,1,102,13,13220,RIVERA,RIVERA,28,26,2,28,26,0,2,0,0,0,26,26,0,0,90,44,46,90,44,46,0,0,0,0,0,0, ,0,1,0,0
1301102015,13,1,102,15,13220,RIVERA,RIVERA,27,25,2,27,25,0,2,0,0,0,25,25,0,0,80,38,42,80,38,42,0,0,0,0,0,0, ,0,1,0,0
1301102016,13,1,102,16,13220,RIVERA,RIVERA,26,23,3,26,23,0,3,0,0,0,23,23,0,0,67,31,36,67,31,36,0,0,0,0,0,0, ,0,1,0,0
1301102017,13,1,102,17,13220,RIVERA,RIVERA,29,29,0,29,29,0,0,0,0,0,29,29,0,0,76,35,41,76,35,41,0,0,0,0,0,0, ,0,1,0,0
1301102018,13,1,102,18,13220,RIVERA,RIVERA,28,26,2,28,26,0,2,0,0,0,27,27,0,0,58,27,31,58,27,31,0,0,0,0,0,0, ,0,1,0,0
1301102019,13,1,102,19,13220,RIVERA,RIVERA,18,13,5,18,13,0,5,0,0,0,13,13,0,0,37,18,19,37,18,19,0,0,0,0,0,0, ,0,1,0,0
1301106001,13,1,106,1,13220,RIVERA,RIVERA,27,22,5,27,22,0,5,0,0,0,23,23,0,0,63,26,37,63,26,37,0,0,0,0,0,0, ,0,1,0,0
1301106002,13,1,106,2,13220,RIVERA,RIVERA,39,34,5,38,33,0,5,1,1,0,34,33,0,1,91,48,43,72,30,42,0,0,0,19,18,1, ,0,1,0,0
1301106003,13,1,106,3,13220,RIVERA,RIVERA,16,13,3,16,13,0,3,0,0,0,13,13,0,0,33,14,19,33,14,19,0,0,0,0,0,0, ,0,1,0,0
1301106004,13,1,106,4,13220,RIVERA,RIVERA,0,0,0,0,0,0,0,0,0,0,0,0,0,0,0,0,0,0,0,0,0,0,0,0,0,0, ,0,1,0,0
1301106005,13,1,106,5,13220,RIVERA,RIVERA,24,24,0,24,24,0,0,0,0,0,26,26,0,0,65,29,36,65,29,36,0,0,0,0,0,0, ,0,1,0,0
1301106006,13,1,106,6,13220,RIVERA,RIVERA,0,0,0,0,0,0,0,0,0,0,0,0,0,0,0,0,0,0,0,0,0,0,0,0,0,0, ,0,1,0,0
1301106007,13,1,106,7,13220,RIVERA,RIVERA,38,36,2,38,36,0,2,0,0,0,36,36,0,0,93,39,54,93,39,54,0,0,0,0,0,0, ,0,1,0,0
1301106008,13,1,106,8,13220,RIVERA,RIVERA,31,26,5,31,26,0,5,0,0,0,26,26,0,0,58,24,34,58,24,34,0,0,0,0,0,0, ,0,1,0,0
1301106009,13,1,106,9,13220,RIVERA,RIVERA,35,30,5,35,30,0,5,0,0,0,30,30,0,0,75,33,42,75,33,42,0,0,0,0,0,0, ,0,1,0,0
1301106010,13,1,106,10,13220,RIVERA,RIVERA,25,22,3,25,22,0,3,0,0,0,22,22,0,0,62,29,33,62,29,33,0,0,0,0,0,0, ,0,1,0,0
1301106011,13,1,106,11,13220,RIVERA,RIVERA,34,31,3,34,31,0,3,0,0,0,31,31,0,0,94,37,57,94,37,57,0,0,0,0,0,0, ,0,1,0,0
1301106012,13,1,106,12,13220,RIVERA,RIVERA,31,29,2,31,29,0,2,0,0,0,31,31,0,0,86,37,49,86,37,49,0,0,0,0,0,0, ,0,1,0,0
1301106013,13,1,106,13,13220,RIVERA,RIVERA,38,34,4,38,34,0,4,0,0,0,34,34,0,0,96,42,54,96,42,54,0,0,0,0,0,0, ,0,1,0,0
1301106014,13,1,106,14,13220,RIVERA,RIVERA,31,29,2,31,29,0,2,0,0,0,30,30,0,0,81,36,45,81,36,45,0,0,0,0,0,0, ,0,1,0,0
1301106016,13,1,106,16,13220,RIVERA,RIVERA,40,34,6,40,34,0,6,0,0,0,34,34,0,0,92,43,49,92,43,49,0,0,0,0,0,0, ,0,1,0,0
1301106017,13,1,106,17,13220,RIVERA,RIVERA,28,26,2,28,26,0,2,0,0,0,26,26,0,0,64,30,34,64,30,34,0,0,0,0,0,0, ,0,1,0,0
1301106018,13,1,106,18,13220,RIVERA,RIVERA,46,43,3,46,43,0,3,0,0,0,43,43,0,0,110,49,61,110,49,61,0,0,0,0,0,0, ,0,1,0,0
1301106019,13,1,106,19,13220,RIVERA,RIVERA,35,33,2,35,33,0,2,0,0,0,33,33,0,0,93,41,52,93,41,52,0,0,0,0,0,0, ,0,1,0,0
1301106020,13,1,106,20,13220,RIVERA,RIVERA,27,24,3,27,24,0,3,0,0,0,24,24,0,0,71,34,37,71,34,37,0,0,0,0,0,0, ,0,1,0,0
1301106600,13,1,106,600,13220,RIVERA,RIVERA,21,20,1,21,20,0,1,0,0,0,20,20,0,0,60,30,30,60,30,30,0,0,0,0,0,0, ,0,1,0,0
1301106601,13,1,106,601,13220,RIVERA,RIVERA,16,16,0,16,16,0,0,0,0,0,16,16,0,0,44,21,23,44,21,23,0,0,0,0,0,0, ,0,1,0,0
1301107001,13,1,107,1,13220,RIVERA,RIVERA,0,0,0,0,0,0,0,0,0,0,0,0,0,0,0,0,0,0,0,0,0,0,0,0,0,0, ,0,1,0,0
1301107002,13,1,107,2,13220,RIVERA,RIVERA,28,26,2,28,26,0,2,0,0,0,26,26,0,0,86,40,46,86,40,46,0,0,0,0,0,0, ,0,1,0,0
1301107003,13,1,107,3,13220,RIVERA,RIVERA,21,17,4,21,17,0,4,0,0,0,17,17,0,0,37,22,15,37,22,15,0,0,0,0,0,0, ,0,1,0,0
1301107004,13,1,107,4,13220,RIVERA,RIVERA,13,11,2,13,11,0,2,0,0,0,11,11,0,0,27,9,18,27,9,18,0,0,0,0,0,0, ,0,1,0,0
1301107005,13,1,107,5,13220,RIVERA,RIVERA,16,8,8,16,8,0,8,0,0,0,8,8,0,0,15,4,11,15,4,11,0,0,0,0,0,0, ,0,1,0,0
1301107006,13,1,107,6,13220,RIVERA,RIVERA,18,13,5,18,13,0,5,0,0,0,13,13,0,0,24,8,16,24,8,16,0,0,0,0,0,0, ,0,1,0,0
1301107007,13,1,107,7,13220,RIVERA,RIVERA,47,43,4,47,43,0,4,0,0,0,43,43,0,0,82,36,46,82,36,46,0,0,0,0,0,0, ,0,1,0,0
1301107008,13,1,107,8,13220,RIVERA,RIVERA,20,18,2,20,18,0,2,0,0,0,18,18,0,0,43,16,27,43,16,27,0,0,0,0,0,0, ,0,1,0,0
1301107009,13,1,107,9,13220,RIVERA,RIVERA,70,58,12,70,58,0,12,0,0,0,58,58,0,0,141,51,90,141,51,90,0,0,0,0,0,0, ,0,1,0,0
1301107010,13,1,107,10,13220,RIVERA,RIVERA,21,18,3,21,18,0,3,0,0,0,18,18,0,0,58,28,30,58,28,30,0,0,0,0,0,0, ,0,1,0,0
1301107011,13,1,107,11,13220,RIVERA,RIVERA,33,29,4,33,29,0,4,0,0,0,30,30,0,0,105,45,60,105,45,60,0,0,0,0,0,0, ,0,1,0,0
1301107012,13,1,107,12,13220,RIVERA,RIVERA,27,24,3,27,24,0,3,0,0,0,25,25,0,0,61,27,34,61,27,34,0,0,0,0,0,0, ,0,1,0,0
1301107013,13,1,107,13,13220,RIVERA,RIVERA,31,29,2,31,29,1,2,0,0,0,29,29,1,0,67,20,47,67,20,47,2,1,1,0,0,0, ,0,1,0,0
1301107401,13,1,107,401,13220,RIVERA,RIVERA,0,0,0,0,0,0,0,0,0,0,0,0,0,0,0,0,0,0,0,0,0,0,0,0,0,0, ,0,1,0,0
1301107402,13,1,107,402,13220,RIVERA,RIVERA,0,0,0,0,0,0,0,0,0,0,0,0,0,0,0,0,0,0,0,0,0,0,0,0,0,0, ,0,1,0,0
1301107403,13,1,107,403,13220,RIVERA,RIVERA,0,0,0,0,0,0,0,0,0,0,0,0,0,0,0,0,0,0,0,0,0,0,0,0,0,0, ,0,1,0,0
1301107404,13,1,107,404,13220,RIVERA,RIVERA,0,0,0,0,0,0,0,0,0,0,0,0,0,0,0,0,0,0,0,0,0,0,0,0,0,0, ,0,1,0,0
1301107600,13,1,107,600,13220,RIVERA,RIVERA,0,0,0,0,0,0,0,0,0,0,0,0,0,0,0,0,0,0,0,0,0,0,0,0,0,0, ,0,1,0,0
1301107700,13,1,107,700,13220,RIVERA,RIVERA,0,0,0,0,0,0,0,0,0,0,0,0,0,0,0,0,0,0,0,0,0,0,0,0,0,0, ,0,1,0,0
1301110002,13,1,110,2,13220,RIVERA,RIVERA,17,11,6,17,11,0,6,0,0,0,11,11,0,0,26,12,14,26,12,14,0,0,0,0,0,0, ,0,1,0,0
1301110003,13,1,110,3,13220,RIVERA,RIVERA,21,14,7,21,14,0,7,0,0,0,14,14,0,0,36,19,17,36,19,17,0,0,0,0,0,0, ,0,1,0,0
1301110004,13,1,110,4,13220,RIVERA,RIVERA,50,46,4,49,45,0,4,1,1,0,46,45,0,1,141,75,66,105,39,66,0,0,0,36,36,0, ,0,1,0,0
1301110005,13,1,110,5,13220,RIVERA,RIVERA,15,15,0,15,15,0,0,0,0,0,15,15,0,0,32,13,19,32,13,19,0,0,0,0,0,0, ,0,1,0,0
1301110007,13,1,110,7,13220,RIVERA,RIVERA,26,23,3,26,23,0,3,0,0,0,24,24,0,0,52,19,33,52,19,33,0,0,0,0,0,0, ,0,1,0,0
1301110008,13,1,110,8,13220,RIVERA,RIVERA,25,22,3,25,22,0,3,0,0,0,22,22,0,0,44,20,24,44,20,24,0,0,0,0,0,0, ,0,1,0,0
1301110009,13,1,110,9,13220,RIVERA,RIVERA,38,23,15,38,23,0,15,0,0,0,23,23,0,0,49,20,29,49,20,29,0,0,0,0,0,0, ,0,1,0,0
1301110010,13,1,110,10,13220,RIVERA,RIVERA,10,8,2,10,8,0,2,0,0,0,8,8,0,0,25,10,15,25,10,15,0,0,0,0,0,0, ,0,1,0,0
1301110011,13,1,110,11,13220,RIVERA,RIVERA,38,26,12,38,26,0,12,0,0,0,26,26,0,0,54,22,32,54,22,32,0,0,0,0,0,0, ,0,1,0,0
1301110012,13,1,110,12,13220,RIVERA,RIVERA,17,14,3,17,14,0,3,0,0,0,14,14,0,0,33,17,16,33,17,16,0,0,0,0,0,0, ,0,1,0,0
1301110013,13,1,110,13,13220,RIVERA,RIVERA,24,23,1,24,23,0,1,0,0,0,23,23,0,0,49,19,30,49,19,30,0,0,0,0,0,0, ,0,1,0,0
1301110014,13,1,110,14,13220,RIVERA,RIVERA,35,32,3,35,32,0,3,0,0,0,32,32,0,0,75,35,40,75,35,40,0,0,0,0,0,0, ,0,1,0,0
1301110400,13,1,110,400,13220,RIVERA,RIVERA,0,0,0,0,0,0,0,0,0,0,0,0,0,0,0,0,0,0,0,0,0,0,0,0,0,0, ,0,1,0,0
1301110401,13,1,110,401,13220,RIVERA,RIVERA,0,0,0,0,0,0,0,0,0,0,0,0,0,0,0,0,0,0,0,0,0,0,0,0,0,0, ,0,1,0,0
1301110403,13,1,110,403,13220,RIVERA,RIVERA,0,0,0,0,0,0,0,0,0,0,0,0,0,0,0,0,0,0,0,0,0,0,0,0,0,0, ,0,1,0,0
1301110404,13,1,110,404,13220,RIVERA,RIVERA,0,0,0,0,0,0,0,0,0,0,0,0,0,0,0,0,0,0,0,0,0,0,0,0,0,0, ,0,1,0,0
1301110405,13,1,110,405,13220,RIVERA,RIVERA,0,0,0,0,0,0,0,0,0,0,0,0,0,0,0,0,0,0,0,0,0,0,0,0,0,0, ,0,1,0,0
1301110406,13,1,110,406,13220,RIVERA,RIVERA,0,0,0,0,0,0,0,0,0,0,0,0,0,0,0,0,0,0,0,0,0,0,0,0,0,0, ,0,1,0,0
1301110407,13,1,110,407,13220,RIVERA,RIVERA,0,0,0,0,0,0,0,0,0,0,0,0,0,0,0,0,0,0,0,0,0,0,0,0,0,0, ,0,1,0,0
1301110408,13,1,110,408,13220,RIVERA,RIVERA,0,0,0,0,0,0,0,0,0,0,0,0,0,0,0,0,0,0,0,0,0,0,0,0,0,0, ,0,1,0,0
1301110409,13,1,110,409,13220,RIVERA,RIVERA,0,0,0,0,0,0,0,0,0,0,0,0,0,0,0,0,0,0,0,0,0,0,0,0,0,0, ,0,1,0,0
1301110410,13,1,110,410,13220,RIVERA,RIVERA,0,0,0,0,0,0,0,0,0,0,0,0,0,0,0,0,0,0,0,0,0,0,0,0,0,0, ,0,1,0,0
1301110411,13,1,110,411,13220,RIVERA,RIVERA,0,0,0,0,0,0,0,0,0,0,0,0,0,0,0,0,0,0,0,0,0,0,0,0,0,0, ,0,1,0,0
1301110500,13,1,110,500,13220,RIVERA,RIVERA,0,0,0,0,0,0,0,0,0,0,0,0,0,0,0,0,0,0,0,0,0,0,0,0,0,0, ,0,1,0,0
1301110600,13,1,110,600,13220,RIVERA,RIVERA,14,13,1,14,13,0,1,0,0,0,13,13,0,0,29,13,16,29,13,16,0,0,0,0,0,0, ,0,1,0,0
1301111001,13,1,111,1,13220,RIVERA,RIVERA,18,11,7,17,10,0,7,1,1,0,11,10,0,1,31,13,18,30,13,17,0,0,0,1,0,1, ,0,1,0,0
1301111002,13,1,111,2,13220,RIVERA,RIVERA,19,18,1,17,16,0,1,2,2,0,25,23,0,2,59,13,46,46,13,33,0,0,0,13,0,13, ,0,1,0,0
1301111003,13,1,111,3,13220,RIVERA,RIVERA,27,22,5,27,22,0,5,0,0,0,24,24,0,0,58,22,36,58,22,36,0,0,0,0,0,0, ,0,1,0,0
1301111009,13,1,111,9,13220,RIVERA,RIVERA,29,28,1,29,28,0,1,0,0,0,28,28,0,0,67,25,42,67,25,42,0,0,0,0,0,0, ,0,1,0,0
1301111010,13,1,111,10,13220,RIVERA,RIVERA,35,30,5,35,30,0,5,0,0,0,30,30,0,0,79,35,44,79,35,44,0,0,0,0,0,0, ,0,1,0,0
1301111011,13,1,111,11,13220,RIVERA,RIVERA,19,17,2,19,17,0,2,0,0,0,17,17,0,0,39,18,21,39,18,21,0,0,0,0,0,0, ,0,1,0,0
1301111012,13,1,111,12,13220,RIVERA,RIVERA,16,15,1,16,15,0,1,0,0,0,15,15,0,0,35,15,20,35,15,20,0,0,0,0,0,0, ,0,1,0,0
1301111013,13,1,111,13,13220,RIVERA,RIVERA,18,15,3,18,15,0,3,0,0,0,16,16,0,0,46,18,28,46,18,28,0,0,0,0,0,0, ,0,1,0,0
1301111014,13,1,111,14,13220,RIVERA,RIVERA,29,28,1,29,28,0,1,0,0,0,29,29,0,0,69,30,39,69,30,39,0,0,0,0,0,0, ,0,1,0,0
1301111021,13,1,111,21,13220,RIVERA,RIVERA,43,35,8,43,35,0,8,0,0,0,35,35,0,0,100,42,58,100,42,58,0,0,0,0,0,0, ,0,1,0,0
1301111022,13,1,111,22,13220,RIVERA,RIVERA,31,26,5,31,26,0,5,0,0,0,26,26,0,0,57,25,32,57,25,32,0,0,0,0,0,0, ,0,1,0,0
1301111023,13,1,111,23,13220,RIVERA,RIVERA,37,31,6,37,31,0,6,0,0,0,31,31,0,0,67,33,34,67,33,34,0,0,0,0,0,0, ,0,1,0,0
1301111024,13,1,111,24,13220,RIVERA,RIVERA,23,17,6,21,16,0,5,2,1,1,18,17,0,1,41,18,23,39,17,22,0,0,0,2,1,1, ,0,1,0,0
1301111025,13,1,111,25,13220,RIVERA,RIVERA,22,22,0,22,22,0,0,0,0,0,23,23,0,0,50,20,30,50,20,30,0,0,0,0,0,0, ,0,1,0,0
1301111026,13,1,111,26,13220,RIVERA,RIVERA,21,20,1,21,20,0,1,0,0,0,20,20,0,0,41,16,25,41,16,25,0,0,0,0,0,0, ,0,1,0,0
1301112001,13,1,112,1,13220,RIVERA,RIVERA,20,17,3,20,17,0,3,0,0,0,17,17,0,0,35,15,20,35,15,20,0,0,0,0,0,0, ,0,1,0,0
1301112002,13,1,112,2,13220,RIVERA,RIVERA,23,17,6,22,16,0,6,1,1,0,17,16,0,1,48,23,25,34,14,20,0,0,0,14,9,5, ,0,1,0,0
1301112003,13,1,112,3,13220,RIVERA,RIVERA,60,55,5,60,55,0,5,0,0,0,55,55,0,0,150,68,82,150,68,82,0,0,0,0,0,0, ,0,1,0,0
1301112010,13,1,112,10,13220,RIVERA,RIVERA,39,32,7,39,32,0,7,0,0,0,32,32,0,0,72,30,42,72,30,42,0,0,0,0,0,0, ,0,1,0,0
1301112011,13,1,112,11,13220,RIVERA,RIVERA,28,26,2,28,26,0,2,0,0,0,26,26,0,0,71,32,39,71,32,39,0,0,0,0,0,0, ,0,1,0,0
1301112012,13,1,112,12,13220,RIVERA,RIVERA,24,19,5,23,18,0,5,1,1,0,19,18,0,1,62,29,33,42,19,23,0,0,0,20,10,10, ,0,1,0,0
1301112013,13,1,112,13,13220,RIVERA,RIVERA,23,19,4,23,19,0,4,0,0,0,20,20,0,0,47,18,29,47,18,29,0,0,0,0,0,0, ,0,1,0,0
1301112014,13,1,112,14,13220,RIVERA,RIVERA,27,24,3,27,24,0,3,0,0,0,26,26,0,0,64,31,33,64,31,33,0,0,0,0,0,0, ,0,1,0,0
1301112015,13,1,112,15,13220,RIVERA,RIVERA,35,32,3,35,32,0,3,0,0,0,34,34,0,0,87,35,52,87,35,52,0,0,0,0,0,0, ,0,1,0,0
1301112022,13,1,112,22,13220,RIVERA,RIVERA,46,43,3,46,43,0,3,0,0,0,43,43,0,0,122,63,59,122,63,59,0,0,0,0,0,0, ,0,1,0,0
1301112023,13,1,112,23,13220,RIVERA,RIVERA,29,26,3,29,26,0,3,0,0,0,26,26,0,0,58,30,28,58,30,28,0,0,0,0,0,0, ,0,1,0,0
1301112024,13,1,112,24,13220,RIVERA,RIVERA,29,23,6,29,23,0,6,0,0,0,23,23,0,0,53,22,31,53,22,31,0,0,0,0,0,0, ,0,1,0,0
1301113001,13,1,113,1,13220,RIVERA,RIVERA,95,84,11,95,84,0,11,0,0,0,85,85,0,0,221,103,118,221,103,118,0,0,0,0,0,0, ,0,1,0,0
1301113002,13,1,113,2,13220,RIVERA,RIVERA,55,47,8,55,47,0,8,0,0,0,47,47,0,0,145,64,81,145,64,81,0,0,0,0,0,0, ,0,1,0,0
1301113005,13,1,113,5,13220,RIVERA,RIVERA,30,27,3,30,27,0,3,0,0,0,27,27,0,0,84,39,45,84,39,45,0,0,0,0,0,0, ,0,1,0,0
1301113006,13,1,113,6,13220,RIVERA,RIVERA,25,22,3,25,22,0,3,0,0,0,23,23,0,0,55,27,28,55,27,28,0,0,0,0,0,0, ,0,1,0,0
1301113008,13,1,113,8,13220,RIVERA,RIVERA,25,22,3,25,22,0,3,0,0,0,22,22,0,0,66,34,32,66,34,32,0,0,0,0,0,0, ,0,1,0,0
1301113009,13,1,113,9,13220,RIVERA,RIVERA,35,22,13,35,22,0,13,0,0,0,22,22,0,0,57,25,32,57,25,32,0,0,0,0,0,0, ,0,1,0,0
1301113010,13,1,113,10,13220,RIVERA,RIVERA,7,7,0,7,7,0,0,0,0,0,7,7,0,0,26,12,14,26,12,14,0,0,0,0,0,0, ,0,1,0,0
1301113011,13,1,113,11,13220,RIVERA,RIVERA,16,16,0,16,16,0,0,0,0,0,16,16,0,0,51,25,26,51,25,26,0,0,0,0,0,0, ,0,1,0,0
1301113012,13,1,113,12,13220,RIVERA,RIVERA,18,12,6,18,12,0,6,0,0,0,12,12,0,0,34,16,18,34,16,18,0,0,0,0,0,0, ,0,1,0,0
1301113022,13,1,113,22,13220,RIVERA,RIVERA,78,67,11,78,67,0,11,0,0,0,67,67,0,0,203,96,107,203,96,107,0,0,0,0,0,0, ,0,1,0,0
1301113023,13,1,113,23,13220,RIVERA,RIVERA,35,33,2,35,33,0,2,0,0,0,35,35,0,0,106,45,61,106,45,61,0,0,0,0,0,0, ,0,1,0,0
1301113024,13,1,113,24,13220,RIVERA,RIVERA,33,29,4,33,29,0,4,0,0,0,29,29,0,0,88,43,45,88,43,45,0,0,0,0,0,0, ,0,1,0,0
1301113400,13,1,113,400,13220,RIVERA,RIVERA,0,0,0,0,0,0,0,0,0,0,0,0,0,0,0,0,0,0,0,0,0,0,0,0,0,0, ,0,9,0,0
1301113401,13,1,113,401,13220,RIVERA,RIVERA,0,0,0,0,0,0,0,0,0,0,0,0,0,0,0,0,0,0,0,0,0,0,0,0,0,0, ,0,1,0,0
1301113402,13,1,113,402,13220,RIVERA,RIVERA,0,0,0,0,0,0,0,0,0,0,0,0,0,0,0,0,0,0,0,0,0,0,0,0,0,0, ,0,1,0,0
1301113403,13,1,113,403,13220,RIVERA,RIVERA,0,0,0,0,0,0,0,0,0,0,0,0,0,0,0,0,0,0,0,0,0,0,0,0,0,0, ,0,1,0,0
1301113404,13,1,113,404,13220,RIVERA,RIVERA,0,0,0,0,0,0,0,0,0,0,0,0,0,0,0,0,0,0,0,0,0,0,0,0,0,0, ,0,1,0,0
1301113405,13,1,113,405,13220,RIVERA,RIVERA,0,0,0,0,0,0,0,0,0,0,0,0,0,0,0,0,0,0,0,0,0,0,0,0,0,0, ,0,1,0,0
1301113406,13,1,113,406,13220,RIVERA,RIVERA,0,0,0,0,0,0,0,0,0,0,0,0,0,0,0,0,0,0,0,0,0,0,0,0,0,0, ,0,1,0,0
1301113407,13,1,113,407,13220,RIVERA,RIVERA,0,0,0,0,0,0,0,0,0,0,0,0,0,0,0,0,0,0,0,0,0,0,0,0,0,0, ,0,9,0,0
1301113408,13,1,113,408,13220,RIVERA,RIVERA,0,0,0,0,0,0,0,0,0,0,0,0,0,0,0,0,0,0,0,0,0,0,0,0,0,0, ,0,9,0,0
1301113409,13,1,113,409,13220,RIVERA,RIVERA,0,0,0,0,0,0,0,0,0,0,0,0,0,0,0,0,0,0,0,0,0,0,0,0,0,0, ,0,9,0,0
1301113410,13,1,113,410,13220,RIVERA,RIVERA,0,0,0,0,0,0,0,0,0,0,0,0,0,0,0,0,0,0,0,0,0,0,0,0,0,0, ,0,9,0,0
1301113411,13,1,113,411,13220,RIVERA,RIVERA,0,0,0,0,0,0,0,0,0,0,0,0,0,0,0,0,0,0,0,0,0,0,0,0,0,0, ,0,1,0,0
1301113412,13,1,113,412,13220,RIVERA,RIVERA,0,0,0,0,0,0,0,0,0,0,0,0,0,0,0,0,0,0,0,0,0,0,0,0,0,0, ,0,1,0,0
1301113413,13,1,113,413,13220,RIVERA,RIVERA,0,0,0,0,0,0,0,0,0,0,0,0,0,0,0,0,0,0,0,0,0,0,0,0,0,0, ,0,1,0,0
1301113414,13,1,113,414,13220,RIVERA,RIVERA,0,0,0,0,0,0,0,0,0,0,0,0,0,0,0,0,0,0,0,0,0,0,0,0,0,0, ,0,1,0,0
1301113600,13,1,113,600,13220,RIVERA,RIVERA,7,7,0,7,7,0,0,0,0,0,7,7,0,0,20,13,7,20,13,7,0,0,0,0,0,0, ,0,1,0,0
1301113601,13,1,113,601,13220,RIVERA,RIVERA,38,31,7,38,31,0,7,0,0,0,32,32,0,0,82,36,46,82,36,46,0,0,0,0,0,0, ,0,1,0,0
1301115001,13,1,115,1,13220,RIVERA,RIVERA,2,1,1,2,1,0,1,0,0,0,1,1,0,0,1,1,0,1,1,0,0,0,0,0,0,0, ,0,1,0,0
1301115002,13,1,115,2,13220,RIVERA,RIVERA,96,90,6,96,90,0,6,0,0,0,91,91,0,0,283,147,136,283,147,136,0,0,0,0,0,0, ,0,1,0,0
1301115003,13,1,115,3,13220,RIVERA,RIVERA,21,20,1,21,20,0,1,0,0,0,20,20,0,0,88,34,54,88,34,54,0,0,0,0,0,0, ,0,1,0,0
1301115006,13,1,115,6,13220,RIVERA,RIVERA,19,13,6,19,13,0,6,0,0,0,13,13,0,0,42,22,20,42,22,20,0,0,0,0,0,0, ,0,1,0,0
1301115010,13,1,115,10,13220,RIVERA,RIVERA,46,37,9,46,37,0,9,0,0,0,37,37,0,0,113,53,60,113,53,60,0,0,0,0,0,0, ,0,1,0,0
1301115011,13,1,115,11,13220,RIVERA,RIVERA,42,38,4,42,38,1,4,0,0,0,38,38,1,0,155,76,79,155,76,79,3,1,2,0,0,0, ,0,1,0,0
1301115012,13,1,115,12,13220,RIVERA,RIVERA,23,17,6,23,17,0,6,0,0,0,17,17,0,0,56,31,25,56,31,25,0,0,0,0,0,0, ,0,1,0,0
1301115013,13,1,115,13,13220,RIVERA,RIVERA,26,26,0,26,26,0,0,0,0,0,27,27,0,0,93,43,50,93,43,50,0,0,0,0,0,0, ,0,1,0,0
1301115014,13,1,115,14,13220,RIVERA,RIVERA,28,23,5,28,23,0,5,0,0,0,23,23,0,0,76,34,42,76,34,42,0,0,0,0,0,0, ,0,1,0,0
1301115015,13,1,115,15,13220,RIVERA,RIVERA,28,24,4,28,24,0,4,0,0,0,24,24,0,0,75,39,36,75,39,36,0,0,0,0,0,0, ,0,1,0,0
1301115016,13,1,115,16,13220,RIVERA,RIVERA,47,45,2,47,45,0,2,0,0,0,45,45,0,0,144,67,77,144,67,77,0,0,0,0,0,0, ,0,1,0,0
1301115018,13,1,115,18,13220,RIVERA,RIVERA,38,35,3,38,35,0,3,0,0,0,35,35,0,0,99,50,49,99,50,49,0,0,0,0,0,0, ,0,1,0,0
1301115019,13,1,115,19,13220,RIVERA,RIVERA,47,45,2,47,45,0,2,0,0,0,47,47,0,0,144,66,78,144,66,78,0,0,0,0,0,0, ,0,1,0,0
1301115043,13,1,115,43,13220,RIVERA,RIVERA,18,14,4,18,14,1,4,0,0,0,14,14,1,0,68,34,34,68,34,34,5,3,2,0,0,0, ,0,1,0,0
1301115045,13,1,115,45,13220,RIVERA,RIVERA,31,23,8,31,23,0,8,0,0,0,23,23,0,0,89,44,45,89,44,45,0,0,0,0,0,0, ,0,1,0,0
1301115046,13,1,115,46,13220,RIVERA,RIVERA,16,10,6,16,10,0,6,0,0,0,10,10,0,0,40,15,25,40,15,25,0,0,0,0,0,0, ,0,1,0,0
1301115047,13,1,115,47,13220,RIVERA,RIVERA,13,13,0,13,13,0,0,0,0,0,13,13,0,0,48,30,18,48,30,18,0,0,0,0,0,0, ,0,1,0,0
1301115048,13,1,115,48,13220,RIVERA,RIVERA,32,28,4,32,28,0,4,0,0,0,28,28,0,0,99,52,47,99,52,47,0,0,0,0,0,0, ,0,1,0,0
1301115600,13,1,115,600,13220,RIVERA,RIVERA,0,0,0,0,0,0,0,0,0,0,0,0,0,0,0,0,0,0,0,0,0,0,0,0,0,0, ,0,1,0,0
1301115601,13,1,115,601,13220,RIVERA,RIVERA,10,10,0,10,10,0,0,0,0,0,10,10,0,0,31,14,17,31,14,17,0,0,0,0,0,0, ,0,1,0,0
1301115602,13,1,115,602,13220,RIVERA,RIVERA,20,19,1,20,19,0,1,0,0,0,19,19,0,0,71,35,36,71,35,36,0,0,0,0,0,0, ,0,1,0,0
1301115603,13,1,115,603,13220,RIVERA,RIVERA,20,19,1,20,19,0,1,0,0,0,19,19,0,0,60,24,36,60,24,36,0,0,0,0,0,0, ,0,1,0,0
1301115604,13,1,115,604,13220,RIVERA,RIVERA,20,19,1,20,19,0,1,0,0,0,19,19,0,0,58,25,33,58,25,33,0,0,0,0,0,0, ,0,1,0,0
1301115605,13,1,115,605,13220,RIVERA,RIVERA,20,19,1,20,19,0,1,0,0,0,19,19,0,0,65,28,37,65,28,37,0,0,0,0,0,0, ,0,1,0,0
1301115606,13,1,115,606,13220,RIVERA,RIVERA,10,9,1,10,9,0,1,0,0,0,9,9,0,0,34,17,17,34,17,17,0,0,0,0,0,0, ,0,1,0,0
1301115607,13,1,115,607,13220,RIVERA,RIVERA,1,1,0,1,1,0,0,0,0,0,1,1,0,0,3,1,2,3,1,2,0,0,0,0,0,0, ,0,1,0,0
1301115608,13,1,115,608,13220,RIVERA,RIVERA,9,8,1,9,8,0,1,0,0,0,8,8,0,0,32,19,13,32,19,13,0,0,0,0,0,0, ,0,1,0,0
1301115609,13,1,115,609,13220,RIVERA,RIVERA,17,17,0,17,17,0,0,0,0,0,17,17,0,0,67,37,30,67,37,30,0,0,0,0,0,0, ,0,1,0,0
1301115610,13,1,115,610,13220,RIVERA,RIVERA,25,15,10,25,15,0,10,0,0,0,15,15,0,0,65,30,35,65,30,35,0,0,0,0,0,0, ,0,1,0,0
1301115611,13,1,115,611,13220,RIVERA,RIVERA,5,5,0,5,5,0,0,0,0,0,5,5,0,0,11,5,6,11,5,6,0,0,0,0,0,0, ,0,1,0,0
1301115614,13,1,115,614,13220,RIVERA,RIVERA,18,17,1,18,17,1,1,0,0,0,17,17,1,0,73,32,41,73,32,41,3,2,1,0,0,0, ,0,1,0,0
1301115615,13,1,115,615,13220,RIVERA,RIVERA,16,15,1,16,15,0,1,0,0,0,15,15,0,0,65,34,31,65,34,31,0,0,0,0,0,0, ,0,1,0,0
1301115616,13,1,115,616,13220,RIVERA,RIVERA,20,15,5,20,15,0,5,0,0,0,15,15,0,0,66,32,34,66,32,34,0,0,0,0,0,0, ,0,1,0,0
1301115617,13,1,115,617,13220,RIVERA,RIVERA,13,13,0,13,13,0,0,0,0,0,13,13,0,0,45,24,21,45,24,21,0,0,0,0,0,0, ,0,1,0,0
1301115618,13,1,115,618,13220,RIVERA,RIVERA,10,10,0,10,10,0,0,0,0,0,10,10,0,0,45,21,24,45,21,24,0,0,0,0,0,0, ,0,1,0,0
1301115619,13,1,115,619,13220,RIVERA,RIVERA,13,13,0,13,13,0,0,0,0,0,13,13,0,0,66,30,36,66,30,36,0,0,0,0,0,0, ,0,1,0,0
1301115620,13,1,115,620,13220,RIVERA,RIVERA,13,13,0,13,13,0,0,0,0,0,13,13,0,0,57,22,35,57,22,35,0,0,0,0,0,0, ,0,1,0,0
1301115621,13,1,115,621,13220,RIVERA,RIVERA,8,8,0,8,8,0,0,0,0,0,8,8,0,0,34,17,17,34,17,17,0,0,0,0,0,0, ,0,1,0,0
1301115622,13,1,115,622,13220,RIVERA,RIVERA,4,3,1,4,3,0,1,0,0,0,3,3,0,0,10,3,7,10,3,7,0,0,0,0,0,0, ,0,1,0,0
1301115623,13,1,115,623,13220,RIVERA,RIVERA,8,8,0,8,8,0,0,0,0,0,8,8,0,0,33,19,14,33,19,14,0,0,0,0,0,0, ,0,1,0,0
1301115624,13,1,115,624,13220,RIVERA,RIVERA,16,16,0,16,16,0,0,0,0,0,16,16,0,0,57,29,28,57,29,28,0,0,0,0,0,0, ,0,1,0,0
1301115625,13,1,115,625,13220,RIVERA,RIVERA,22,22,0,22,22,0,0,0,0,0,22,22,0,0,59,28,31,59,28,31,0,0,0,0,0,0, ,0,1,0,0
1301115626,13,1,115,626,13220,RIVERA,RIVERA,4,4,0,4,4,0,0,0,0,0,4,4,0,0,15,9,6,15,9,6,0,0,0,0,0,0, ,0,1,0,0
1301115627,13,1,115,627,13220,RIVERA,RIVERA,0,0,0,0,0,0,0,0,0,0,0,0,0,0,0,0,0,0,0,0,0,0,0,0,0,0, ,0,1,0,0
1301115628,13,1,115,628,13220,RIVERA,RIVERA,3,0,3,3,0,0,3,0,0,0,0,0,0,0,0,0,0,0,0,0,0,0,0,0,0,0, ,0,1,0,0
1301115629,13,1,115,629,13220,RIVERA,RIVERA,23,23,0,23,23,0,0,0,0,0,23,23,0,0,94,40,54,94,40,54,0,0,0,0,0,0, ,0,1,0,0
1301115630,13,1,115,630,13220,RIVERA,RIVERA,28,27,1,28,27,0,1,0,0,0,27,27,0,0,108,56,52,108,56,52,0,0,0,0,0,0, ,0,1,0,0
1301115631,13,1,115,631,13220,RIVERA,RIVERA,8,5,3,8,5,0,3,0,0,0,5,5,0,0,24,11,13,24,11,13,0,0,0,0,0,0, ,0,1,0,0
1301115700,13,1,115,700,13220,RIVERA,RIVERA,13,11,2,13,11,0,2,0,0,0,11,11,0,0,36,16,20,36,16,20,0,0,0,0,0,0, ,0,1,0,0
1301115701,13,1,115,701,13220,RIVERA,RIVERA,4,4,0,4,4,0,0,0,0,0,4,4,0,0,17,6,11,17,6,11,0,0,0,0,0,0, ,0,1,0,0
1301115702,13,1,115,702,13220,RIVERA,RIVERA,22,20,2,22,20,0,2,0,0,0,20,20,0,0,88,42,46,88,42,46,0,0,0,0,0,0, ,0,1,0,0
1301115800,13,1,115,800,13220,RIVERA,RIVERA,2,2,0,2,2,0,0,0,0,0,2,2,0,0,5,2,3,5,2,3,0,0,0,0,0,0, ,0,1,0,0
1301115801,13,1,115,801,13220,RIVERA,RIVERA,1,1,0,1,1,0,0,0,0,0,1,1,0,0,2,1,1,2,1,1,0,0,0,0,0,0, ,0,1,0,0
1301115802,13,1,115,802,13220,RIVERA,RIVERA,3,1,2,3,1,0,2,0,0,0,1,1,0,0,2,1,1,2,1,1,0,0,0,0,0,0, ,0,1,0,0
1301115803,13,1,115,803,13220,RIVERA,RIVERA,0,0,0,0,0,0,0,0,0,0,0,0,0,0,0,0,0,0,0,0,0,0,0,0,0,0, ,0,1,0,0
1301115806,13,1,115,806,13220,RIVERA,RIVERA,30,22,8,30,22,0,8,0,0,0,22,22,0,0,76,43,33,76,43,33,0,0,0,0,0,0, ,0,1,0,0
1301115811,13,1,115,811,13220,RIVERA,RIVERA,1,1,0,1,1,0,0,0,0,0,1,1,0,0,1,1,0,1,1,0,0,0,0,0,0,0, ,0,1,0,0
1301115814,13,1,115,814,13220,RIVERA,RIVERA,10,10,0,10,10,0,0,0,0,0,10,10,0,0,44,22,22,44,22,22,0,0,0,0,0,0, ,0,1,0,0
1301115817,13,1,115,817,13220,RIVERA,RIVERA,8,8,0,8,8,0,0,0,0,0,8,8,0,0,28,13,15,28,13,15,0,0,0,0,0,0, ,0,1,0,0
1301115818,13,1,115,818,13220,RIVERA,RIVERA,10,10,0,10,10,0,0,0,0,0,10,10,0,0,30,16,14,30,16,14,0,0,0,0,0,0, ,0,1,0,0
1301116001,13,1,116,1,13220,RIVERA,RIVERA,23,21,2,23,21,0,2,0,0,0,21,21,0,0,83,33,50,83,33,50,0,0,0,0,0,0, ,0,1,0,0
1301116002,13,1,116,2,13220,RIVERA,RIVERA,32,31,1,32,31,0,1,0,0,0,31,31,0,0,130,67,63,130,67,63,0,0,0,0,0,0, ,0,1,0,0
1301116003,13,1,116,3,13220,RIVERA,RIVERA,23,20,3,23,20,0,3,0,0,0,20,20,0,0,54,25,29,54,25,29,0,0,0,0,0,0, ,0,1,0,0
1301116007,13,1,116,7,13220,RIVERA,RIVERA,29,23,6,29,23,0,6,0,0,0,23,23,0,0,66,26,40,66,26,40,0,0,0,0,0,0, ,0,1,0,0
1301116008,13,1,116,8,13220,RIVERA,RIVERA,28,26,2,28,26,0,2,0,0,0,26,26,0,0,82,34,48,82,34,48,0,0,0,0,0,0, ,0,1,0,0
1301116009,13,1,116,9,13220,RIVERA,RIVERA,25,24,1,25,24,0,1,0,0,0,24,24,0,0,75,36,39,75,36,39,0,0,0,0,0,0, ,0,1,0,0
1301116010,13,1,116,10,13220,RIVERA,RIVERA,25,20,5,25,20,0,5,0,0,0,20,20,0,0,53,25,28,53,25,28,0,0,0,0,0,0, ,0,1,0,0
1301116011,13,1,116,11,13220,RIVERA,RIVERA,38,37,1,38,37,0,1,0,0,0,37,37,0,0,113,57,56,113,57,56,0,0,0,0,0,0, ,0,1,0,0
1301116012,13,1,116,12,13220,RIVERA,RIVERA,29,27,2,29,27,0,2,0,0,0,27,27,0,0,74,35,39,74,35,39,0,0,0,0,0,0, ,0,1,0,0
1301116020,13,1,116,20,13220,RIVERA,RIVERA,32,27,5,32,27,0,5,0,0,0,28,28,0,0,79,39,40,79,39,40,0,0,0,0,0,0, ,0,1,0,0
1301116021,13,1,116,21,13220,RIVERA,RIVERA,39,34,5,39,34,0,5,0,0,0,34,34,0,0,72,37,35,72,37,35,0,0,0,0,0,0, ,0,1,0,0
1301116022,13,1,116,22,13220,RIVERA,RIVERA,35,33,2,35,33,0,2,0,0,0,33,33,0,0,81,32,49,81,32,49,0,0,0,0,0,0, ,0,1,0,0
1301116023,13,1,116,23,13220,RIVERA,RIVERA,26,25,1,26,25,0,1,0,0,0,26,26,0,0,76,29,47,76,29,47,0,0,0,0,0,0, ,0,1,0,0
1301116024,13,1,116,24,13220,RIVERA,RIVERA,37,33,4,37,33,0,4,0,0,0,33,33,0,0,93,48,45,93,48,45,0,0,0,0,0,0, ,0,1,0,0
1301116025,13,1,116,25,13220,RIVERA,RIVERA,34,32,2,34,32,0,2,0,0,0,32,32,0,0,97,43,54,97,43,54,0,0,0,0,0,0, ,0,1,0,0
1301119001,13,1,119,1,13220,RIVERA,RIVERA,23,23,0,23,23,0,0,0,0,0,23,23,0,0,68,32,36,68,32,36,0,0,0,0,0,0, ,0,1,0,0
1301119002,13,1,119,2,13220,RIVERA,RIVERA,31,28,3,31,28,0,3,0,0,0,28,28,0,0,58,25,33,58,25,33,0,0,0,0,0,0, ,0,1,0,0
1301119003,13,1,119,3,13220,RIVERA,RIVERA,30,27,3,30,27,0,3,0,0,0,27,27,0,0,56,20,36,56,20,36,0,0,0,0,0,0, ,0,1,0,0
1301119009,13,1,119,9,13220,RIVERA,RIVERA,32,28,4,32,28,0,4,0,0,0,28,28,0,0,57,28,29,57,28,29,0,0,0,0,0,0, ,0,1,0,0
1301119010,13,1,119,10,13220,RIVERA,RIVERA,31,28,3,31,28,0,3,0,0,0,28,28,0,0,61,26,35,61,26,35,0,0,0,0,0,0, ,0,1,0,0
1301119011,13,1,119,11,13220,RIVERA,RIVERA,31,28,3,31,28,0,3,0,0,0,28,28,0,0,86,33,53,86,33,53,0,0,0,0,0,0, ,0,1,0,0
1301119012,13,1,119,12,13220,RIVERA,RIVERA,31,29,2,31,29,0,2,0,0,0,29,29,0,0,70,27,43,70,27,43,0,0,0,0,0,0, ,0,1,0,0
1301119018,13,1,119,18,13220,RIVERA,RIVERA,26,21,5,26,21,0,5,0,0,0,21,21,0,0,60,24,36,60,24,36,0,0,0,0,0,0, ,0,1,0,0
1301119019,13,1,119,19,13220,RIVERA,RIVERA,28,24,4,28,24,0,4,0,0,0,24,24,0,0,59,26,33,59,26,33,0,0,0,0,0,0, ,0,1,0,0
1301119020,13,1,119,20,13220,RIVERA,RIVERA,29,25,4,29,25,0,4,0,0,0,25,25,0,0,77,38,39,77,38,39,0,0,0,0,0,0, ,0,1,0,0
1301119021,13,1,119,21,13220,RIVERA,RIVERA,38,34,4,38,34,0,4,0,0,0,34,34,0,0,98,46,52,98,46,52,0,0,0,0,0,0, ,0,9,0,0
1301119022,13,1,119,22,13220,RIVERA,RIVERA,40,30,10,40,30,0,10,0,0,0,30,30,0,0,85,36,49,85,36,49,0,0,0,0,0,0, ,0,9,0,0
1301119023,13,1,119,23,13220,RIVERA,RIVERA,35,27,8,35,27,0,8,0,0,0,27,27,0,0,80,41,39,80,41,39,0,0,0,0,0,0, ,0,9,0,0
1301119024,13,1,119,24,13220,RIVERA,RIVERA,45,36,9,45,36,0,9,0,0,0,37,37,0,0,117,59,58,117,59,58,0,0,0,0,0,0, ,0,9,0,0
1301119401,13,1,119,401,13220,RIVERA,RIVERA,0,0,0,0,0,0,0,0,0,0,0,0,0,0,0,0,0,0,0,0,0,0,0,0,0,0, ,0,1,0,0
1301119402,13,1,119,402,13220,RIVERA,RIVERA,0,0,0,0,0,0,0,0,0,0,0,0,0,0,0,0,0,0,0,0,0,0,0,0,0,0, ,0,1,0,0
1301119403,13,1,119,403,13220,RIVERA,RIVERA,0,0,0,0,0,0,0,0,0,0,0,0,0,0,0,0,0,0,0,0,0,0,0,0,0,0, ,0,1,0,0
1301201018,13,1,201,18,13220,RIVERA,RIVERA,23,20,3,23,20,0,3,0,0,0,20,20,0,0,47,22,25,47,22,25,0,0,0,0,0,0, ,0,1,0,0
1301201019,13,1,201,19,13220,RIVERA,RIVERA,27,21,6,27,21,0,6,0,0,0,21,21,0,0,66,29,37,66,29,37,0,0,0,0,0,0, ,0,1,0,0
1301201020,13,1,201,20,13220,RIVERA,RIVERA,27,26,1,27,26,0,1,0,0,0,26,26,0,0,77,36,41,77,36,41,0,0,0,0,0,0, ,0,1,0,0
1301201025,13,1,201,25,13220,RIVERA,RIVERA,32,31,1,32,31,0,1,0,0,0,31,31,0,0,80,40,40,80,40,40,0,0,0,0,0,0, ,0,1,0,0
1301201026,13,1,201,26,13220,RIVERA,RIVERA,22,21,1,22,21,0,1,0,0,0,21,21,0,0,68,32,36,68,32,36,0,0,0,0,0,0, ,0,1,0,0
1301201027,13,1,201,27,13220,RIVERA,RIVERA,19,16,3,19,16,0,3,0,0,0,16,16,0,0,47,23,24,47,23,24,0,0,0,0,0,0, ,0,1,0,0
1301201028,13,1,201,28,13220,RIVERA,RIVERA,33,32,1,33,32,0,1,0,0,0,32,32,0,0,99,48,51,99,48,51,0,0,0,0,0,0, ,0,1,0,0
1301201029,13,1,201,29,13220,RIVERA,RIVERA,26,25,1,26,25,1,1,0,0,0,25,25,1,0,70,32,38,70,32,38,2,1,1,0,0,0, ,0,1,0,0
1301201031,13,1,201,31,13220,RIVERA,RIVERA,8,8,0,8,8,0,0,0,0,0,8,8,0,0,18,9,9,18,9,9,0,0,0,0,0,0, ,0,1,0,0
1301201032,13,1,201,32,13220,RIVERA,RIVERA,14,14,0,14,14,0,0,0,0,0,15,15,0,0,40,17,23,40,17,23,0,0,0,0,0,0, ,0,1,0,0
1301201033,13,1,201,33,13220,RIVERA,RIVERA,26,25,1,26,25,0,1,0,0,0,32,32,0,0,89,41,48,89,41,48,0,0,0,0,0,0, ,0,1,0,0
1301201034,13,1,201,34,13220,RIVERA,RIVERA,29,25,4,29,25,0,4,0,0,0,25,25,0,0,78,28,50,78,28,50,0,0,0,0,0,0, ,0,1,0,0
1301201037,13,1,201,37,13220,RIVERA,RIVERA,35,35,0,35,35,0,0,0,0,0,37,37,0,0,133,65,68,133,65,68,0,0,0,0,0,0, ,0,1,0,0
1301201038,13,1,201,38,13220,RIVERA,RIVERA,5,4,1,5,4,0,1,0,0,0,4,4,0,0,10,2,8,10,2,8,0,0,0,0,0,0, ,0,1,0,0
1301201039,13,1,201,39,13220,RIVERA,RIVERA,27,21,6,27,21,0,6,0,0,0,21,21,0,0,70,34,36,70,34,36,0,0,0,0,0,0, ,0,1,0,0
1301201040,13,1,201,40,13220,RIVERA,RIVERA,32,29,3,32,29,0,3,0,0,0,29,29,0,0,73,39,34,73,39,34,0,0,0,0,0,0, ,0,1,0,0
1301201041,13,1,201,41,13220,RIVERA,RIVERA,34,34,0,34,34,0,0,0,0,0,34,34,0,0,94,45,49,94,45,49,0,0,0,0,0,0, ,0,1,0,0
1301201042,13,1,201,42,13220,RIVERA,RIVERA,31,29,2,31,29,0,2,0,0,0,29,29,0,0,73,27,46,73,27,46,0,0,0,0,0,0, ,0,1,0,0
1301201043,13,1,201,43,13220,RIVERA,RIVERA,29,29,0,29,29,0,0,0,0,0,29,29,0,0,88,45,43,88,45,43,0,0,0,0,0,0, ,0,1,0,0
1301201130,13,1,201,130,13220,RIVERA,RIVERA,15,12,3,15,12,0,3,0,0,0,12,12,0,0,30,15,15,30,15,15,0,0,0,0,0,0, ,0,1,0,0
1301201230,13,1,201,230,13220,RIVERA,RIVERA,17,15,2,17,15,0,2,0,0,0,16,16,0,0,38,14,24,38,14,24,0,0,0,0,0,0, ,0,1,0,0
1301201401,13,1,201,401,13220,RIVERA,RIVERA,0,0,0,0,0,0,0,0,0,0,0,0,0,0,0,0,0,0,0,0,0,0,0,0,0,0, ,0,1,0,0
1301201402,13,1,201,402,13220,RIVERA,RIVERA,0,0,0,0,0,0,0,0,0,0,0,0,0,0,0,0,0,0,0,0,0,0,0,0,0,0, ,0,1,0,0
1301201403,13,1,201,403,13220,RIVERA,RIVERA,0,0,0,0,0,0,0,0,0,0,0,0,0,0,0,0,0,0,0,0,0,0,0,0,0,0, ,0,1,0,0
1301201600,13,1,201,600,13220,RIVERA,RIVERA,23,21,2,23,21,0,2,0,0,0,21,21,0,0,59,28,31,59,28,31,0,0,0,0,0,0, ,0,1,0,0
1301202014,13,1,202,14,13220,RIVERA,RIVERA,8,8,0,8,8,0,0,0,0,0,8,8,0,0,30,17,13,30,17,13,0,0,0,0,0,0, ,0,1,0,0
1301202020,13,1,202,20,13220,RIVERA,RIVERA,33,30,3,33,30,0,3,0,0,0,30,30,0,0,72,37,35,72,37,35,0,0,0,0,0,0, ,0,1,0,0
1301202021,13,1,202,21,13220,RIVERA,RIVERA,31,30,1,31,30,0,1,0,0,0,30,30,0,0,99,46,53,99,46,53,0,0,0,0,0,0, ,0,1,0,0
1301202022,13,1,202,22,13220,RIVERA,RIVERA,23,22,1,23,22,0,1,0,0,0,23,23,0,0,83,40,43,83,40,43,0,0,0,0,0,0, ,0,1,0,0
1301202023,13,1,202,23,13220,RIVERA,RIVERA,28,28,0,28,28,0,0,0,0,0,28,28,0,0,95,40,55,95,40,55,0,0,0,0,0,0, ,0,1,0,0
1301202024,13,1,202,24,13220,RIVERA,RIVERA,6,6,0,6,6,0,0,0,0,0,6,6,0,0,26,13,13,26,13,13,0,0,0,0,0,0, ,0,1,0,0
1301202025,13,1,202,25,13220,RIVERA,RIVERA,25,25,0,25,25,0,0,0,0,0,25,25,0,0,81,43,38,81,43,38,0,0,0,0,0,0, ,0,1,0,0
1301202026,13,1,202,26,13220,RIVERA,RIVERA,31,29,2,31,29,0,2,0,0,0,30,30,0,0,68,29,39,68,29,39,0,0,0,0,0,0, ,0,1,0,0
1301202027,13,1,202,27,13220,RIVERA,RIVERA,19,17,2,19,17,0,2,0,0,0,17,17,0,0,57,27,30,57,27,30,0,0,0,0,0,0, ,0,1,0,0
1301202028,13,1,202,28,13220,RIVERA,RIVERA,29,26,3,28,25,0,3,1,1,0,26,25,0,1,77,36,41,76,35,41,0,0,0,1,1,0, ,0,1,0,0
1301202029,13,1,202,29,13220,RIVERA,RIVERA,28,24,4,28,24,0,4,0,0,0,24,24,0,0,73,38,35,73,38,35,0,0,0,0,0,0, ,0,1,0,0
1301202030,13,1,202,30,13220,RIVERA,RIVERA,5,5,0,5,5,0,0,0,0,0,5,5,0,0,21,11,10,21,11,10,0,0,0,0,0,0, ,0,1,0,0
1301202031,13,1,202,31,13220,RIVERA,RIVERA,30,28,2,30,28,0,2,0,0,0,28,28,0,0,84,39,45,84,39,45,0,0,0,0,0,0, ,0,1,0,0
1301202032,13,1,202,32,13220,RIVERA,RIVERA,27,26,1,27,26,0,1,0,0,0,26,26,0,0,68,32,36,68,32,36,0,0,0,0,0,0, ,0,1,0,0
1301202033,13,1,202,33,13220,RIVERA,RIVERA,19,17,2,19,17,0,2,0,0,0,17,17,0,0,52,26,26,52,26,26,0,0,0,0,0,0, ,0,1,0,0
1301202034,13,1,202,34,13220,RIVERA,RIVERA,25,20,5,25,20,0,5,0,0,0,21,21,0,0,74,41,33,74,41,33,0,0,0,0,0,0, ,0,1,0,0
1301202035,13,1,202,35,13220,RIVERA,RIVERA,20,16,4,20,16,0,4,0,0,0,16,16,0,0,47,23,24,47,23,24,0,0,0,0,0,0, ,0,1,0,0
1301202036,13,1,202,36,13220,RIVERA,RIVERA,0,0,0,0,0,0,0,0,0,0,0,0,0,0,0,0,0,0,0,0,0,0,0,0,0,0, ,0,1,0,0
1301202401,13,1,202,401,13220,RIVERA,RIVERA,0,0,0,0,0,0,0,0,0,0,0,0,0,0,0,0,0,0,0,0,0,0,0,0,0,0, ,0,1,0,0
1301202600,13,1,202,600,13220,RIVERA,RIVERA,0,0,0,0,0,0,0,0,0,0,0,0,0,0,0,0,0,0,0,0,0,0,0,0,0,0, ,0,1,0,0
1301202601,13,1,202,601,13220,RIVERA,RIVERA,17,16,1,17,16,0,1,0,0,0,18,18,0,0,71,30,41,71,30,41,0,0,0,0,0,0, ,0,1,0,0
1301206021,13,1,206,21,13220,RIVERA,RIVERA,28,27,1,28,27,0,1,0,0,0,27,27,0,0,84,39,45,84,39,45,0,0,0,0,0,0, ,0,1,0,0
1301206022,13,1,206,22,13220,RIVERA,RIVERA,32,32,0,32,32,0,0,0,0,0,32,32,0,0,72,29,43,72,29,43,0,0,0,0,0,0, ,0,1,0,0
1301206023,13,1,206,23,13220,RIVERA,RIVERA,32,29,3,32,29,0,3,0,0,0,29,29,0,0,99,51,48,99,51,48,0,0,0,0,0,0, ,0,1,0,0
1301206024,13,1,206,24,13220,RIVERA,RIVERA,33,32,1,33,32,0,1,0,0,0,32,32,0,0,88,39,49,88,39,49,0,0,0,0,0,0, ,0,1,0,0
1301206025,13,1,206,25,13220,RIVERA,RIVERA,35,30,5,35,30,0,5,0,0,0,30,30,0,0,70,31,39,70,31,39,0,0,0,0,0,0, ,0,1,0,0
1301206026,13,1,206,26,13220,RIVERA,RIVERA,35,32,3,35,32,0,3,0,0,0,32,32,0,0,86,38,48,86,38,48,0,0,0,0,0,0, ,0,1,0,0
1301206027,13,1,206,27,13220,RIVERA,RIVERA,32,32,0,32,32,0,0,0,0,0,32,32,0,0,89,46,43,89,46,43,0,0,0,0,0,0, ,0,1,0,0
1301206028,13,1,206,28,13220,RIVERA,RIVERA,43,42,1,43,42,0,1,0,0,0,43,43,0,0,124,62,62,124,62,62,0,0,0,0,0,0, ,0,1,0,0
1301206029,13,1,206,29,13220,RIVERA,RIVERA,34,29,5,34,29,0,5,0,0,0,29,29,0,0,89,42,47,89,42,47,0,0,0,0,0,0, ,0,1,0,0
1301206030,13,1,206,30,13220,RIVERA,RIVERA,32,28,4,32,28,0,4,0,0,0,29,29,0,0,90,40,50,90,40,50,0,0,0,0,0,0, ,0,1,0,0
1301206032,13,1,206,32,13220,RIVERA,RIVERA,18,15,3,18,15,0,3,0,0,0,15,15,0,0,47,18,29,47,18,29,0,0,0,0,0,0, ,0,1,0,0
1301206034,13,1,206,34,13220,RIVERA,RIVERA,14,13,1,14,13,0,1,0,0,0,13,13,0,0,38,19,19,38,19,19,0,0,0,0,0,0, ,0,1,0,0
1301206035,13,1,206,35,13220,RIVERA,RIVERA,35,30,5,35,30,0,5,0,0,0,30,30,0,0,99,50,49,99,50,49,0,0,0,0,0,0, ,0,1,0,0
1301206037,13,1,206,37,13220,RIVERA,RIVERA,44,42,2,44,42,0,2,0,0,0,42,42,0,0,151,76,75,151,76,75,0,0,0,0,0,0, ,0,1,0,0
1301206038,13,1,206,38,13220,RIVERA,RIVERA,36,35,1,36,35,0,1,0,0,0,35,35,0,0,141,72,69,141,72,69,0,0,0,0,0,0, ,0,1,0,0
1301206401,13,1,206,401,13220,RIVERA,RIVERA,0,0,0,0,0,0,0,0,0,0,0,0,0,0,0,0,0,0,0,0,0,0,0,0,0,0, ,0,1,0,0
1301206402,13,1,206,402,13220,RIVERA,RIVERA,0,0,0,0,0,0,0,0,0,0,0,0,0,0,0,0,0,0,0,0,0,0,0,0,0,0, ,0,1,0,0
1301206404,13,1,206,404,13220,RIVERA,RIVERA,0,0,0,0,0,0,0,0,0,0,0,0,0,0,0,0,0,0,0,0,0,0,0,0,0,0, ,0,1,0,0
1301206405,13,1,206,405,13220,RIVERA,RIVERA,0,0,0,0,0,0,0,0,0,0,0,0,0,0,0,0,0,0,0,0,0,0,0,0,0,0, ,0,1,0,0
1301206406,13,1,206,406,13220,RIVERA,RIVERA,0,0,0,0,0,0,0,0,0,0,0,0,0,0,0,0,0,0,0,0,0,0,0,0,0,0, ,0,1,0,0
1301206407,13,1,206,407,13220,RIVERA,RIVERA,0,0,0,0,0,0,0,0,0,0,0,0,0,0,0,0,0,0,0,0,0,0,0,0,0,0, ,0,1,0,0
1301206600,13,1,206,600,13220,RIVERA,RIVERA,22,22,0,22,22,0,0,0,0,0,22,22,0,0,99,52,47,99,52,47,0,0,0,0,0,0, ,0,1,0,0
1301206601,13,1,206,601,13220,RIVERA,RIVERA,63,60,3,63,60,0,3,0,0,0,60,60,0,0,244,132,112,244,132,112,0,0,0,0,0,0, ,0,1,0,0
1301206602,13,1,206,602,13220,RIVERA,RIVERA,12,10,2,12,10,0,2,0,0,0,10,10,0,0,34,13,21,34,13,21,0,0,0,0,0,0, ,0,1,0,0
1301206603,13,1,206,603,13220,RIVERA,RIVERA,27,26,1,27,26,0,1,0,0,0,26,26,0,0,93,48,45,93,48,45,0,0,0,0,0,0, ,0,1,0,0
1301206800,13,1,206,800,13220,RIVERA,RIVERA,41,39,2,41,39,0,2,0,0,0,39,39,0,0,118,53,65,118,53,65,0,0,0,0,0,0, ,0,1,0,0
1301206801,13,1,206,801,13220,RIVERA,RIVERA,29,28,1,29,28,0,1,0,0,0,30,30,0,0,73,37,36,73,37,36,0,0,0,0,0,0, ,0,1,0,0
1301207014,13,1,207,14,13220,RIVERA,RIVERA,18,17,1,18,17,0,1,0,0,0,17,17,0,0,32,13,19,32,13,19,0,0,0,0,0,0, ,0,1,0,0
1301207015,13,1,207,15,13220,RIVERA,RIVERA,10,6,4,10,6,0,4,0,0,0,6,6,0,0,10,6,4,10,6,4,0,0,0,0,0,0, ,0,1,0,0
1301207016,13,1,207,16,13220,RIVERA,RIVERA,79,72,7,79,72,0,7,0,0,0,73,73,0,0,143,58,85,143,58,85,0,0,0,0,0,0, ,0,1,0,0
1301207017,13,1,207,17,13220,RIVERA,RIVERA,17,17,0,17,17,0,0,0,0,0,18,18,0,0,45,24,21,45,24,21,0,0,0,0,0,0, ,0,1,0,0
1301207018,13,1,207,18,13220,RIVERA,RIVERA,28,25,3,28,25,1,3,0,0,0,25,25,1,0,48,20,28,48,20,28,3,0,3,0,0,0, ,0,1,0,0
1301207019,13,1,207,19,13220,RIVERA,RIVERA,23,22,1,23,22,0,1,0,0,0,22,22,0,0,54,22,32,54,22,32,0,0,0,0,0,0, ,0,1,0,0
1301207020,13,1,207,20,13220,RIVERA,RIVERA,25,21,4,25,21,0,4,0,0,0,21,21,0,0,66,33,33,66,33,33,0,0,0,0,0,0, ,0,1,0,0
1301207021,13,1,207,21,13220,RIVERA,RIVERA,25,25,0,25,25,0,0,0,0,0,25,25,0,0,72,36,36,72,36,36,0,0,0,0,0,0, ,0,1,0,0
1301207022,13,1,207,22,13220,RIVERA,RIVERA,25,21,4,24,20,0,4,1,1,0,21,20,0,1,76,22,54,56,20,36,0,0,0,20,2,18, ,0,1,0,0
1301207023,13,1,207,23,13220,RIVERA,RIVERA,35,25,10,35,25,1,10,0,0,0,25,25,1,0,56,24,32,56,24,32,3,2,1,0,0,0, ,0,1,0,0
1301207024,13,1,207,24,13220,RIVERA,RIVERA,20,14,6,20,14,0,6,0,0,0,14,14,0,0,24,8,16,24,8,16,0,0,0,0,0,0, ,0,1,0,0
1301207025,13,1,207,25,13220,RIVERA,RIVERA,63,49,14,63,49,0,14,0,0,0,49,49,0,0,94,40,54,94,40,54,0,0,0,0,0,0, ,0,1,0,0
1301210015,13,1,210,15,13220,RIVERA,RIVERA,40,33,7,40,33,0,7,0,0,0,33,33,0,0,73,28,45,73,28,45,0,0,0,0,0,0, ,0,1,0,0
1301210016,13,1,210,16,13220,RIVERA,RIVERA,21,13,8,21,13,0,8,0,0,0,13,13,0,0,39,18,21,39,18,21,0,0,0,0,0,0, ,0,1,0,0
1301210017,13,1,210,17,13220,RIVERA,RIVERA,38,25,13,38,25,0,13,0,0,0,26,26,0,0,65,29,36,65,29,36,0,0,0,0,0,0, ,0,1,0,0
1301210018,13,1,210,18,13220,RIVERA,RIVERA,36,30,6,36,30,0,6,0,0,0,30,30,0,0,67,24,43,67,24,43,0,0,0,0,0,0, ,0,1,0,0
1301210019,13,1,210,19,13220,RIVERA,RIVERA,40,28,12,40,28,0,12,0,0,0,29,29,0,0,84,35,49,84,35,49,0,0,0,0,0,0, ,0,1,0,0
1301210020,13,1,210,20,13220,RIVERA,RIVERA,19,13,6,19,13,0,6,0,0,0,13,13,0,0,32,15,17,32,15,17,0,0,0,0,0,0, ,0,1,0,0
1301210021,13,1,210,21,13220,RIVERA,RIVERA,15,12,3,15,12,0,3,0,0,0,12,12,0,0,27,13,14,27,13,14,0,0,0,0,0,0, ,0,1,0,0
1301210022,13,1,210,22,13220,RIVERA,RIVERA,23,17,6,23,17,0,6,0,0,0,17,17,0,0,27,12,15,27,12,15,0,0,0,0,0,0, ,0,1,0,0
1301210023,13,1,210,23,13220,RIVERA,RIVERA,15,14,1,15,14,0,1,0,0,0,14,14,0,0,36,15,21,36,15,21,0,0,0,0,0,0, ,0,1,0,0
1301210024,13,1,210,24,13220,RIVERA,RIVERA,29,26,3,29,26,4,3,0,0,0,26,26,4,0,69,35,34,69,35,34,10,5,5,0,0,0, ,0,1,0,0
1301210025,13,1,210,25,13220,RIVERA,RIVERA,34,27,7,34,27,2,7,0,0,0,28,28,2,0,72,34,38,72,34,38,4,2,2,0,0,0, ,0,1,0,0
1301210026,13,1,210,26,13220,RIVERA,RIVERA,24,18,6,24,18,0,6,0,0,0,19,19,0,0,48,22,26,48,22,26,0,0,0,0,0,0, ,0,1,0,0
1301210027,13,1,210,27,13220,RIVERA,RIVERA,31,25,6,31,25,0,6,0,0,0,25,25,0,0,60,26,34,60,26,34,0,0,0,0,0,0, ,0,1,0,0
1301210028,13,1,210,28,13220,RIVERA,RIVERA,30,26,4,30,26,0,4,0,0,0,26,26,0,0,70,34,36,70,34,36,0,0,0,0,0,0, ,0,1,0,0
1301210400,13,1,210,400,13220,RIVERA,RIVERA,0,0,0,0,0,0,0,0,0,0,0,0,0,0,0,0,0,0,0,0,0,0,0,0,0,0, ,0,1,0,0
1301211004,13,1,211,4,13220,RIVERA,RIVERA,24,22,2,23,21,0,2,1,1,0,22,21,0,1,57,27,30,48,18,30,0,0,0,9,9,0, ,0,1,0,0
1301211005,13,1,211,5,13220,RIVERA,RIVERA,8,8,0,8,8,0,0,0,0,0,9,9,0,0,19,8,11,19,8,11,0,0,0,0,0,0, ,0,1,0,0
1301211006,13,1,211,6,13220,RIVERA,RIVERA,36,34,2,36,34,0,2,0,0,0,37,37,0,0,100,48,52,100,48,52,0,0,0,0,0,0, ,0,1,0,0
1301211007,13,1,211,7,13220,RIVERA,RIVERA,109,93,16,109,93,0,16,0,0,0,93,93,0,0,219,97,122,219,97,122,0,0,0,0,0,0, ,0,1,0,0
1301211008,13,1,211,8,13220,RIVERA,RIVERA,14,10,4,14,10,0,4,0,0,0,10,10,0,0,31,15,16,31,15,16,0,0,0,0,0,0, ,0,1,0,0
1301211018,13,1,211,18,13220,RIVERA,RIVERA,23,22,1,23,22,0,1,0,0,0,24,24,0,0,68,27,41,68,27,41,0,0,0,0,0,0, ,0,1,0,0
1301211019,13,1,211,19,13220,RIVERA,RIVERA,28,28,0,28,28,0,0,0,0,0,29,29,0,0,76,37,39,76,37,39,0,0,0,0,0,0, ,0,1,0,0
1301211020,13,1,211,20,13220,RIVERA,RIVERA,25,23,2,25,23,0,2,0,0,0,23,23,0,0,62,23,39,62,23,39,0,0,0,0,0,0, ,0,1,0,0
1301211027,13,1,211,27,13220,RIVERA,RIVERA,31,28,3,31,28,0,3,0,0,0,28,28,0,0,69,28,41,69,28,41,0,0,0,0,0,0, ,0,1,0,0
1301211028,13,1,211,28,13220,RIVERA,RIVERA,13,9,4,13,9,0,4,0,0,0,9,9,0,0,21,10,11,21,10,11,0,0,0,0,0,0, ,0,1,0,0
1301211029,13,1,211,29,13220,RIVERA,RIVERA,10,8,2,10,8,0,2,0,0,0,8,8,0,0,23,10,13,23,10,13,0,0,0,0,0,0, ,0,1,0,0
1301211401,13,1,211,401,13220,RIVERA,RIVERA,0,0,0,0,0,0,0,0,0,0,0,0,0,0,0,0,0,0,0,0,0,0,0,0,0,0, ,0,1,0,0
1301211403,13,1,211,403,13220,RIVERA,RIVERA,0,0,0,0,0,0,0,0,0,0,0,0,0,0,0,0,0,0,0,0,0,0,0,0,0,0, ,0,1,0,0
1301211404,13,1,211,404,13220,RIVERA,RIVERA,0,0,0,0,0,0,0,0,0,0,0,0,0,0,0,0,0,0,0,0,0,0,0,0,0,0, ,0,1,0,0
1301211600,13,1,211,600,13220,RIVERA,RIVERA,87,49,38,87,49,0,38,0,0,0,49,49,0,0,119,56,63,119,56,63,0,0,0,0,0,0, ,0,1,0,0
1301211601,13,1,211,601,13220,RIVERA,RIVERA,19,19,0,19,19,0,0,0,0,0,19,19,0,0,52,24,28,52,24,28,0,0,0,0,0,0, ,0,1,0,0
1301211602,13,1,211,602,13220,RIVERA,RIVERA,24,23,1,24,23,0,1,0,0,0,23,23,0,0,65,30,35,65,30,35,0,0,0,0,0,0, ,0,1,0,0
1301212004,13,1,212,4,13220,RIVERA,RIVERA,34,32,2,34,32,0,2,0,0,0,33,33,0,0,80,31,49,80,31,49,0,0,0,0,0,0, ,0,1,0,0
1301212005,13,1,212,5,13220,RIVERA,RIVERA,61,58,3,60,57,0,3,1,1,0,58,57,0,1,154,91,63,113,50,63,0,0,0,41,41,0, ,0,1,0,0
1301212006,13,1,212,6,13220,RIVERA,RIVERA,27,25,2,27,25,0,2,0,0,0,26,26,0,0,68,29,39,68,29,39,0,0,0,0,0,0, ,0,1,0,0
1301212007,13,1,212,7,13220,RIVERA,RIVERA,27,25,2,27,25,0,2,0,0,0,25,25,0,0,68,23,45,68,23,45,0,0,0,0,0,0, ,0,1,0,0
1301212008,13,1,212,8,13220,RIVERA,RIVERA,25,22,3,25,22,0,3,0,0,0,22,22,0,0,58,25,33,58,25,33,0,0,0,0,0,0, ,0,1,0,0
1301212009,13,1,212,9,13220,RIVERA,RIVERA,30,26,4,30,26,0,4,0,0,0,26,26,0,0,67,32,35,67,32,35,0,0,0,0,0,0, ,0,1,0,0
1301212016,13,1,212,16,13220,RIVERA,RIVERA,27,26,1,27,26,0,1,0,0,0,26,26,0,0,64,31,33,64,31,33,0,0,0,0,0,0, ,0,1,0,0
1301212017,13,1,212,17,13220,RIVERA,RIVERA,34,33,1,34,33,0,1,0,0,0,34,34,0,0,80,35,45,80,35,45,0,0,0,0,0,0, ,0,1,0,0
1301212018,13,1,212,18,13220,RIVERA,RIVERA,30,28,2,30,28,0,2,0,0,0,31,31,0,0,71,28,43,71,28,43,0,0,0,0,0,0, ,0,1,0,0
1301212019,13,1,212,19,13220,RIVERA,RIVERA,28,25,3,28,25,0,3,0,0,0,25,25,0,0,60,27,33,60,27,33,0,0,0,0,0,0, ,0,1,0,0
1301212020,13,1,212,20,13220,RIVERA,RIVERA,38,36,2,38,36,0,2,0,0,0,36,36,0,0,80,33,47,80,33,47,0,0,0,0,0,0, ,0,1,0,0
1301212021,13,1,212,21,13220,RIVERA,RIVERA,27,23,4,27,23,0,4,0,0,0,23,23,0,0,75,35,40,75,35,40,0,0,0,0,0,0, ,0,1,0,0
1301212402,13,1,212,402,13220,RIVERA,RIVERA,0,0,0,0,0,0,0,0,0,0,0,0,0,0,0,0,0,0,0,0,0,0,0,0,0,0, ,0,1,0,0
1301212403,13,1,212,403,13220,RIVERA,RIVERA,0,0,0,0,0,0,0,0,0,0,0,0,0,0,0,0,0,0,0,0,0,0,0,0,0,0, ,0,1,0,0
1301212404,13,1,212,404,13220,RIVERA,RIVERA,0,0,0,0,0,0,0,0,0,0,0,0,0,0,0,0,0,0,0,0,0,0,0,0,0,0, ,0,1,0,0
1301212405,13,1,212,405,13220,RIVERA,RIVERA,0,0,0,0,0,0,0,0,0,0,0,0,0,0,0,0,0,0,0,0,0,0,0,0,0,0, ,0,1,0,0
1301213014,13,1,213,14,13220,RIVERA,RIVERA,31,28,3,31,28,0,3,0,0,0,28,28,0,0,78,38,40,78,38,40,0,0,0,0,0,0, ,0,1,0,0
1301213015,13,1,213,15,13220,RIVERA,RIVERA,41,38,3,41,38,1,3,0,0,0,38,38,1,0,106,49,57,106,49,57,2,1,1,0,0,0, ,0,1,0,0
1301213016,13,1,213,16,13220,RIVERA,RIVERA,27,23,4,27,23,0,4,0,0,0,23,23,0,0,69,27,42,69,27,42,0,0,0,0,0,0, ,0,1,0,0
1301213018,13,1,213,18,13220,RIVERA,RIVERA,9,9,0,9,9,0,0,0,0,0,9,9,0,0,26,12,14,26,12,14,0,0,0,0,0,0, ,0,1,0,0
1301213019,13,1,213,19,13220,RIVERA,RIVERA,35,21,14,35,21,0,14,0,0,0,21,21,0,0,59,23,36,59,23,36,0,0,0,0,0,0, ,0,1,0,0
1301213020,13,1,213,20,13220,RIVERA,RIVERA,27,18,9,27,18,0,9,0,0,0,18,18,0,0,44,21,23,44,21,23,0,0,0,0,0,0, ,0,1,0,0
1301213021,13,1,213,21,13220,RIVERA,RIVERA,37,25,12,37,25,0,12,0,0,0,25,25,0,0,68,29,39,68,29,39,0,0,0,0,0,0, ,0,1,0,0
1301213025,13,1,213,25,13220,RIVERA,RIVERA,21,18,3,21,18,0,3,0,0,0,18,18,0,0,62,28,34,62,28,34,0,0,0,0,0,0, ,0,1,0,0
1301213400,13,1,213,400,13220,RIVERA,RIVERA,0,0,0,0,0,0,0,0,0,0,0,0,0,0,0,0,0,0,0,0,0,0,0,0,0,0, ,0,1,0,0
1301213401,13,1,213,401,13220,RIVERA,RIVERA,0,0,0,0,0,0,0,0,0,0,0,0,0,0,0,0,0,0,0,0,0,0,0,0,0,0, ,0,1,0,0
1301213402,13,1,213,402,13220,RIVERA,RIVERA,0,0,0,0,0,0,0,0,0,0,0,0,0,0,0,0,0,0,0,0,0,0,0,0,0,0, ,0,1,0,0
1301213403,13,1,213,403,13220,RIVERA,RIVERA,0,0,0,0,0,0,0,0,0,0,0,0,0,0,0,0,0,0,0,0,0,0,0,0,0,0, ,0,1,0,0
1301213404,13,1,213,404,13220,RIVERA,RIVERA,0,0,0,0,0,0,0,0,0,0,0,0,0,0,0,0,0,0,0,0,0,0,0,0,0,0, ,0,1,0,0
1301213405,13,1,213,405,13220,RIVERA,RIVERA,0,0,0,0,0,0,0,0,0,0,0,0,0,0,0,0,0,0,0,0,0,0,0,0,0,0, ,0,1,0,0
1301213406,13,1,213,406,13220,RIVERA,RIVERA,0,0,0,0,0,0,0,0,0,0,0,0,0,0,0,0,0,0,0,0,0,0,0,0,0,0, ,0,1,0,0
1301213407,13,1,213,407,13220,RIVERA,RIVERA,0,0,0,0,0,0,0,0,0,0,0,0,0,0,0,0,0,0,0,0,0,0,0,0,0,0, ,0,9,0,0
1301213408,13,1,213,408,13220,RIVERA,RIVERA,0,0,0,0,0,0,0,0,0,0,0,0,0,0,0,0,0,0,0,0,0,0,0,0,0,0, ,0,1,0,0
1301213409,13,1,213,409,13220,RIVERA,RIVERA,0,0,0,0,0,0,0,0,0,0,0,0,0,0,0,0,0,0,0,0,0,0,0,0,0,0, ,0,9,0,0
1301213410,13,1,213,410,13220,RIVERA,RIVERA,0,0,0,0,0,0,0,0,0,0,0,0,0,0,0,0,0,0,0,0,0,0,0,0,0,0, ,0,1,0,0
1301213411,13,1,213,411,13220,RIVERA,RIVERA,0,0,0,0,0,0,0,0,0,0,0,0,0,0,0,0,0,0,0,0,0,0,0,0,0,0, ,0,1,0,0
1301213600,13,1,213,600,13220,RIVERA,RIVERA,29,26,3,29,26,0,3,0,0,0,26,26,0,0,76,32,44,76,32,44,0,0,0,0,0,0, ,0,1,0,0
1301213601,13,1,213,601,13220,RIVERA,RIVERA,104,89,15,104,89,0,15,0,0,0,89,89,0,0,176,63,113,176,63,113,0,0,0,0,0,0, ,0,1,0,0
1301213602,13,1,213,602,13220,RIVERA,RIVERA,24,23,1,24,23,0,1,0,0,0,23,23,0,0,33,11,22,33,11,22,0,0,0,0,0,0, ,0,1,0,0
1301213603,13,1,213,603,13220,RIVERA,RIVERA,73,65,8,73,65,0,8,0,0,0,65,65,0,0,146,54,92,146,54,92,0,0,0,0,0,0, ,0,1,0,0
1301215020,13,1,215,20,13220,RIVERA,RIVERA,44,41,3,44,41,0,3,0,0,0,42,42,0,0,129,65,64,129,65,64,0,0,0,0,0,0, ,0,1,0,0
1301215021,13,1,215,21,13220,RIVERA,RIVERA,38,34,4,38,34,0,4,0,0,0,34,34,0,0,109,54,55,109,54,55,0,0,0,0,0,0, ,0,1,0,0
1301215024,13,1,215,24,13220,RIVERA,RIVERA,19,19,0,19,19,0,0,0,0,0,19,19,0,0,52,23,29,52,23,29,0,0,0,0,0,0, ,0,1,0,0
1301215025,13,1,215,25,13220,RIVERA,RIVERA,29,27,2,29,27,0,2,0,0,0,27,27,0,0,97,45,52,97,45,52,0,0,0,0,0,0, ,0,1,0,0
1301215028,13,1,215,28,13220,RIVERA,RIVERA,13,13,0,13,13,0,0,0,0,0,13,13,0,0,32,17,15,32,17,15,0,0,0,0,0,0, ,0,1,0,0
1301215029,13,1,215,29,13220,RIVERA,RIVERA,19,17,2,19,17,0,2,0,0,0,17,17,0,0,60,29,31,60,29,31,0,0,0,0,0,0, ,0,1,0,0
1301215030,13,1,215,30,13220,RIVERA,RIVERA,25,24,1,25,24,0,1,0,0,0,24,24,0,0,76,41,35,76,41,35,0,0,0,0,0,0, ,0,1,0,0
1301215031,13,1,215,31,13220,RIVERA,RIVERA,26,21,5,26,21,0,5,0,0,0,21,21,0,0,60,28,32,60,28,32,0,0,0,0,0,0, ,0,1,0,0
1301215032,13,1,215,32,13220,RIVERA,RIVERA,21,19,2,21,19,0,2,0,0,0,19,19,0,0,67,35,32,67,35,32,0,0,0,0,0,0, ,0,1,0,0
1301215033,13,1,215,33,13220,RIVERA,RIVERA,26,25,1,26,25,0,1,0,0,0,25,25,0,0,80,38,42,80,38,42,0,0,0,0,0,0, ,0,1,0,0
1301215034,13,1,215,34,13220,RIVERA,RIVERA,12,11,1,12,11,0,1,0,0,0,11,11,0,0,34,15,19,34,15,19,0,0,0,0,0,0, ,0,1,0,0
1301215035,13,1,215,35,13220,RIVERA,RIVERA,22,20,2,22,20,0,2,0,0,0,20,20,0,0,52,28,24,52,28,24,0,0,0,0,0,0, ,0,1,0,0
1301215036,13,1,215,36,13220,RIVERA,RIVERA,27,26,1,27,26,0,1,0,0,0,26,26,0,0,85,32,53,85,32,53,0,0,0,0,0,0, ,0,1,0,0
1301215037,13,1,215,37,13220,RIVERA,RIVERA,10,10,0,10,10,0,0,0,0,0,10,10,0,0,30,17,13,30,17,13,0,0,0,0,0,0, ,0,1,0,0
1301215041,13,1,215,41,13220,RIVERA,RIVERA,20,19,1,20,19,0,1,0,0,0,20,20,0,0,68,33,35,68,33,35,0,0,0,0,0,0, ,0,1,0,0
1301215053,13,1,215,53,13220,RIVERA,RIVERA,21,17,4,21,17,0,4,0,0,0,17,17,0,0,62,31,31,62,31,31,0,0,0,0,0,0, ,0,1,0,0
1301215054,13,1,215,54,13220,RIVERA,RIVERA,26,25,1,26,25,0,1,0,0,0,25,25,0,0,97,47,50,97,47,50,0,0,0,0,0,0, ,0,1,0,0
1301215056,13,1,215,56,13220,RIVERA,RIVERA,18,18,0,18,18,0,0,0,0,0,18,18,0,0,57,27,30,57,27,30,0,0,0,0,0,0, ,0,1,0,0
1301215057,13,1,215,57,13220,RIVERA,RIVERA,19,17,2,19,17,0,2,0,0,0,17,17,0,0,56,23,33,56,23,33,0,0,0,0,0,0, ,0,1,0,0
1301215400,13,1,215,400,13220,RIVERA,RIVERA,0,0,0,0,0,0,0,0,0,0,0,0,0,0,0,0,0,0,0,0,0,0,0,0,0,0, ,0,1,0,0
1301215602,13,1,215,602,13220,RIVERA,RIVERA,27,27,0,27,27,0,0,0,0,0,27,27,0,0,95,51,44,95,51,44,0,0,0,0,0,0, ,0,1,0,0
1301215603,13,1,215,603,13220,RIVERA,RIVERA,5,5,0,5,5,0,0,0,0,0,5,5,0,0,19,6,13,19,6,13,0,0,0,0,0,0, ,0,1,0,0
1301215604,13,1,215,604,13220,RIVERA,RIVERA,8,8,0,8,8,0,0,0,0,0,8,8,0,0,28,14,14,28,14,14,0,0,0,0,0,0, ,0,1,0,0
1301215606,13,1,215,606,13220,RIVERA,RIVERA,52,52,0,52,52,0,0,0,0,0,52,52,0,0,181,89,92,181,89,92,0,0,0,0,0,0, ,0,1,0,0
1301215700,13,1,215,700,13220,RIVERA,RIVERA,14,14,0,14,14,0,0,0,0,0,14,14,0,0,59,31,28,59,31,28,0,0,0,0,0,0, ,0,1,0,0
1301215701,13,1,215,701,13220,RIVERA,RIVERA,8,7,1,8,7,0,1,0,0,0,7,7,0,0,26,12,14,26,12,14,0,0,0,0,0,0, ,0,1,0,0
1301215702,13,1,215,702,13220,RIVERA,RIVERA,14,13,1,14,13,0,1,0,0,0,13,13,0,0,53,30,23,53,30,23,0,0,0,0,0,0, ,0,1,0,0
1301215703,13,1,215,703,13220,RIVERA,RIVERA,8,8,0,8,8,0,0,0,0,0,8,8,0,0,26,14,12,26,14,12,0,0,0,0,0,0, ,0,1,0,0
1301215704,13,1,215,704,13220,RIVERA,RIVERA,33,33,0,33,33,0,0,0,0,0,33,33,0,0,137,72,65,137,72,65,0,0,0,0,0,0, ,0,1,0,0
1301215705,13,1,215,705,13220,RIVERA,RIVERA,8,8,0,8,8,0,0,0,0,0,8,8,0,0,25,10,15,25,10,15,0,0,0,0,0,0, ,0,1,0,0
1301215706,13,1,215,706,13220,RIVERA,RIVERA,21,19,2,21,19,0,2,0,0,0,19,19,0,0,84,41,43,84,41,43,0,0,0,0,0,0, ,0,1,0,0
1301215707,13,1,215,707,13220,RIVERA,RIVERA,16,15,1,16,15,0,1,0,0,0,15,15,0,0,57,29,28,57,29,28,0,0,0,0,0,0, ,0,1,0,0
1301215800,13,1,215,800,13220,RIVERA,RIVERA,8,8,0,8,8,0,0,0,0,0,8,8,0,0,31,15,16,31,15,16,0,0,0,0,0,0, ,0,1,0,0
1301215802,13,1,215,802,13220,RIVERA,RIVERA,16,16,0,16,16,0,0,0,0,0,16,16,0,0,59,28,31,59,28,31,0,0,0,0,0,0, ,0,1,0,0
1301216004,13,1,216,4,13220,RIVERA,RIVERA,2,1,1,2,1,0,1,0,0,0,1,1,0,0,4,2,2,4,2,2,0,0,0,0,0,0, ,0,1,0,0
1301216006,13,1,216,6,13220,RIVERA,RIVERA,18,17,1,18,17,0,1,0,0,0,17,17,0,0,50,18,32,50,18,32,0,0,0,0,0,0, ,0,1,0,0
1301216013,13,1,216,13,13220,RIVERA,RIVERA,40,34,6,40,34,0,6,0,0,0,34,34,0,0,111,61,50,111,61,50,0,0,0,0,0,0, ,0,1,0,0
1301216014,13,1,216,14,13220,RIVERA,RIVERA,41,35,6,41,35,0,6,0,0,0,35,35,0,0,79,39,40,79,39,40,0,0,0,0,0,0, ,0,1,0,0
1301216015,13,1,216,15,13220,RIVERA,RIVERA,22,22,0,22,22,0,0,0,0,0,22,22,0,0,79,45,34,79,45,34,0,0,0,0,0,0, ,0,1,0,0
1301216016,13,1,216,16,13220,RIVERA,RIVERA,13,13,0,13,13,0,0,0,0,0,13,13,0,0,35,16,19,35,16,19,0,0,0,0,0,0, ,0,1,0,0
1301216017,13,1,216,17,13220,RIVERA,RIVERA,33,31,2,33,31,0,2,0,0,0,31,31,0,0,89,44,45,89,44,45,0,0,0,0,0,0, ,0,1,0,0
1301216018,13,1,216,18,13220,RIVERA,RIVERA,35,32,3,35,32,0,3,0,0,0,32,32,0,0,107,49,58,107,49,58,0,0,0,0,0,0, ,0,1,0,0
1301216019,13,1,216,19,13220,RIVERA,RIVERA,22,21,1,22,21,0,1,0,0,0,21,21,0,0,60,22,38,60,22,38,0,0,0,0,0,0, ,0,1,0,0
1301216026,13,1,216,26,13220,RIVERA,RIVERA,30,28,2,30,28,0,2,0,0,0,28,28,0,0,77,37,40,77,37,40,0,0,0,0,0,0, ,0,1,0,0
1301216027,13,1,216,27,13220,RIVERA,RIVERA,32,29,3,32,29,0,3,0,0,0,29,29,0,0,85,35,50,85,35,50,0,0,0,0,0,0, ,0,1,0,0
1301216028,13,1,216,28,13220,RIVERA,RIVERA,27,21,6,27,21,0,6,0,0,0,21,21,0,0,63,30,33,63,30,33,0,0,0,0,0,0, ,0,1,0,0
1301216400,13,1,216,400,13220,RIVERA,RIVERA,0,0,0,0,0,0,0,0,0,0,0,0,0,0,0,0,0,0,0,0,0,0,0,0,0,0, ,0,1,0,0
1301216401,13,1,216,401,13220,RIVERA,RIVERA,0,0,0,0,0,0,0,0,0,0,0,0,0,0,0,0,0,0,0,0,0,0,0,0,0,0, ,0,1,0,0
1301216402,13,1,216,402,13220,RIVERA,RIVERA,0,0,0,0,0,0,0,0,0,0,0,0,0,0,0,0,0,0,0,0,0,0,0,0,0,0, ,0,1,0,0
1301216403,13,1,216,403,13220,RIVERA,RIVERA,0,0,0,0,0,0,0,0,0,0,0,0,0,0,0,0,0,0,0,0,0,0,0,0,0,0, ,0,1,0,0
1301216600,13,1,216,600,13220,RIVERA,RIVERA,6,6,0,6,6,0,0,0,0,0,6,6,0,0,20,12,8,20,12,8,0,0,0,0,0,0, ,0,1,0,0
1301219004,13,1,219,4,13220,RIVERA,RIVERA,33,32,1,33,32,0,1,0,0,0,32,32,0,0,84,33,51,84,33,51,0,0,0,0,0,0, ,0,1,0,0
1301219005,13,1,219,5,13220,RIVERA,RIVERA,26,24,2,26,24,0,2,0,0,0,24,24,0,0,58,26,32,58,26,32,0,0,0,0,0,0, ,0,1,0,0
1301219006,13,1,219,6,13220,RIVERA,RIVERA,52,50,2,52,50,0,2,0,0,0,50,50,0,0,126,59,67,126,59,67,0,0,0,0,0,0, ,0,1,0,0
1301219007,13,1,219,7,13220,RIVERA,RIVERA,21,21,0,21,21,0,0,0,0,0,21,21,0,0,61,25,36,61,25,36,0,0,0,0,0,0, ,0,1,0,0
1301219008,13,1,219,8,13220,RIVERA,RIVERA,20,18,2,20,18,0,2,0,0,0,18,18,0,0,56,23,33,56,23,33,0,0,0,0,0,0, ,0,1,0,0
1301219013,13,1,219,13,13220,RIVERA,RIVERA,16,16,0,16,16,0,0,0,0,0,16,16,0,0,34,12,22,34,12,22,0,0,0,0,0,0, ,0,1,0,0
1301219014,13,1,219,14,13220,RIVERA,RIVERA,24,21,3,24,21,0,3,0,0,0,21,21,0,0,71,34,37,71,34,37,0,0,0,0,0,0, ,0,1,0,0
1301219016,13,1,219,16,13220,RIVERA,RIVERA,21,21,0,21,21,0,0,0,0,0,21,21,0,0,58,29,29,58,29,29,0,0,0,0,0,0, ,0,1,0,0
1301219017,13,1,219,17,13220,RIVERA,RIVERA,28,24,4,28,24,0,4,0,0,0,25,25,0,0,66,28,38,66,28,38,0,0,0,0,0,0, ,0,1,0,0
1301219025,13,1,219,25,13220,RIVERA,RIVERA,1,0,1,1,0,0,1,0,0,0,0,0,0,0,0,0,0,0,0,0,0,0,0,0,0,0, ,0,9,0,0
1301219026,13,1,219,26,13220,RIVERA,RIVERA,47,47,0,47,47,0,0,0,0,0,50,50,0,0,148,75,73,148,75,73,0,0,0,0,0,0, ,0,9,0,0
1301219402,13,1,219,402,13220,RIVERA,RIVERA,0,0,0,0,0,0,0,0,0,0,0,0,0,0,0,0,0,0,0,0,0,0,0,0,0,0, ,0,1,0,0
1301219403,13,1,219,403,13220,RIVERA,RIVERA,0,0,0,0,0,0,0,0,0,0,0,0,0,0,0,0,0,0,0,0,0,0,0,0,0,0, ,0,1,0,0
1301219404,13,1,219,404,13220,RIVERA,RIVERA,0,0,0,0,0,0,0,0,0,0,0,0,0,0,0,0,0,0,0,0,0,0,0,0,0,0, ,0,1,0,0
1301219405,13,1,219,405,13220,RIVERA,RIVERA,0,0,0,0,0,0,0,0,0,0,0,0,0,0,0,0,0,0,0,0,0,0,0,0,0,0, ,0,1,0,0
1301219801,13,1,219,801,13220,RIVERA,RIVERA,17,17,0,17,17,0,0,0,0,0,17,17,0,0,51,28,23,51,28,23,0,0,0,0,0,0, ,0,1,0,0
1301219802,13,1,219,802,13220,RIVERA,RIVERA,16,13,3,16,13,0,3,0,0,0,13,13,0,0,45,25,20,45,25,20,0,0,0,0,0,0, ,0,1,0,0
1301301044,13,1,301,44,13220,RIVERA,RIVERA,27,24,3,27,24,0,3,0,0,0,26,26,0,0,78,38,40,78,38,40,0,0,0,0,0,0, ,0,1,0,0
1301301045,13,1,301,45,13220,RIVERA,RIVERA,29,27,2,29,27,0,2,0,0,0,28,28,0,0,76,33,43,76,33,43,0,0,0,0,0,0, ,0,1,0,0
1301301046,13,1,301,46,13220,RIVERA,RIVERA,29,28,1,29,28,0,1,0,0,0,32,32,0,0,83,38,45,83,38,45,0,0,0,0,0,0, ,0,1,0,0
1301301047,13,1,301,47,13220,RIVERA,RIVERA,36,35,1,36,35,0,1,0,0,0,35,35,0,0,91,47,44,91,47,44,0,0,0,0,0,0, ,0,1,0,0
1301301048,13,1,301,48,13220,RIVERA,RIVERA,36,33,3,36,33,0,3,0,0,0,34,34,0,0,113,57,56,113,57,56,0,0,0,0,0,0, ,0,1,0,0
1301301051,13,1,301,51,13220,RIVERA,RIVERA,35,31,4,35,31,0,4,0,0,0,31,31,0,0,101,49,52,101,49,52,0,0,0,0,0,0, ,0,1,0,0
1301301052,13,1,301,52,13220,RIVERA,RIVERA,30,30,0,30,30,0,0,0,0,0,30,30,0,0,76,35,41,76,35,41,0,0,0,0,0,0, ,0,1,0,0
1301301053,13,1,301,53,13220,RIVERA,RIVERA,32,26,6,32,26,0,6,0,0,0,27,27,0,0,94,49,45,94,49,45,0,0,0,0,0,0, ,0,1,0,0
1301301054,13,1,301,54,13220,RIVERA,RIVERA,21,20,1,21,20,0,1,0,0,0,20,20,0,0,64,27,37,64,27,37,0,0,0,0,0,0, ,0,1,0,0
1301301055,13,1,301,55,13220,RIVERA,RIVERA,30,22,8,30,22,0,8,0,0,0,22,22,0,0,54,22,32,54,22,32,0,0,0,0,0,0, ,0,1,0,0
1301301056,13,1,301,56,13220,RIVERA,RIVERA,27,24,3,26,23,0,3,1,1,0,24,23,0,1,83,44,39,66,27,39,0,0,0,17,17,0, ,0,1,0,0
1301301057,13,1,301,57,13220,RIVERA,RIVERA,27,24,3,27,24,0,3,0,0,0,24,24,0,0,70,32,38,70,32,38,0,0,0,0,0,0, ,0,1,0,0
1301301058,13,1,301,58,13220,RIVERA,RIVERA,27,23,4,27,23,0,4,0,0,0,24,24,0,0,62,27,35,62,27,35,0,0,0,0,0,0, ,0,1,0,0
1301301059,13,1,301,59,13220,RIVERA,RIVERA,23,18,5,22,17,0,5,1,1,0,19,18,0,1,86,35,51,57,24,33,0,0,0,29,11,18, ,0,1,0,0
1301301060,13,1,301,60,13220,RIVERA,RIVERA,29,24,5,29,24,0,5,0,0,0,24,24,0,0,55,28,27,55,28,27,0,0,0,0,0,0, ,0,1,0,0
1301301061,13,1,301,61,13220,RIVERA,RIVERA,30,27,3,30,27,0,3,0,0,0,28,28,0,0,74,32,42,74,32,42,0,0,0,0,0,0, ,0,1,0,0
1301301401,13,1,301,401,13220,RIVERA,RIVERA,0,0,0,0,0,0,0,0,0,0,0,0,0,0,0,0,0,0,0,0,0,0,0,0,0,0, ,0,1,0,0
1301301600,13,1,301,600,13220,RIVERA,RIVERA,25,24,1,25,24,0,1,0,0,0,24,24,0,0,88,44,44,88,44,44,0,0,0,0,0,0, ,0,1,0,0
1301301800,13,1,301,800,13220,RIVERA,RIVERA,46,33,13,46,33,0,13,0,0,0,33,33,0,0,114,59,55,114,59,55,0,0,0,0,0,0, ,0,1,0,0
1301301801,13,1,301,801,13220,RIVERA,RIVERA,6,5,1,6,5,0,1,0,0,0,5,5,0,0,22,10,12,22,10,12,0,0,0,0,0,0, ,0,1,0,0
1301315061,13,1,315,61,13220,RIVERA,RIVERA,9,7,2,9,7,0,2,0,0,0,7,7,0,0,26,10,16,26,10,16,0,0,0,0,0,0, ,0,1,0,0
1301315064,13,1,315,64,13220,RIVERA,RIVERA,0,0,0,0,0,0,0,0,0,0,0,0,0,0,0,0,0,0,0,0,0,0,0,0,0,0, ,0,1,0,0
1301315600,13,1,315,600,13220,RIVERA,RIVERA,10,10,0,10,10,0,0,0,0,0,10,10,0,0,35,20,15,35,20,15,0,0,0,0,0,0, ,0,1,0,0
1301315601,13,1,315,601,13220,RIVERA,RIVERA,0,0,0,0,0,0,0,0,0,0,0,0,0,0,0,0,0,0,0,0,0,0,0,0,0,0, ,0,1,0,0
1309004001,13,9,4,1,13220,RIVERA,RIVERA,0,0,0,0,0,0,0,0,0,0,0,0,0,0,0,0,0,0,0,0,0,0,0,0,0,0, ,0,10,0,0
1309004003,13,9,4,3,13220,RIVERA,RIVERA,65,65,0,65,65,0,0,0,0,0,66,66,0,0,207,116,91,207,116,91,0,0,0,0,0,0, ,0,10,0,0
1309004005,13,9,4,5,13220,RIVERA,RIVERA,0,0,0,0,0,0,0,0,0,0,0,0,0,0,0,0,0,0,0,0,0,0,0,0,0,0, ,0,10,0,0
1309004006,13,9,4,6,13220,RIVERA,RIVERA,24,23,1,24,23,0,1,0,0,0,24,24,0,0,68,35,33,68,35,33,0,0,0,0,0,0, ,0,10,0,0
1309004007,13,9,4,7,13220,RIVERA,RIVERA,1,1,0,1,1,0,0,0,0,0,1,1,0,0,5,3,2,5,3,2,0,0,0,0,0,0, ,0,10,0,0
1309004008,13,9,4,8,13220,RIVERA,RIVERA,22,20,2,22,20,0,2,0,0,0,21,21,0,0,77,40,37,77,40,37,0,0,0,0,0,0, ,0,10,0,0
1309004009,13,9,4,9,13220,RIVERA,RIVERA,6,2,4,6,2,0,4,0,0,0,2,2,0,0,7,2,5,7,2,5,0,0,0,0,0,0, ,0,10,0,0
1309004012,13,9,4,12,13220,RIVERA,RIVERA,24,21,3,24,21,0,3,0,0,0,22,22,0,0,76,36,40,76,36,40,0,0,0,0,0,0, ,0,10,0,0
1309004013,13,9,4,13,13220,RIVERA,RIVERA,7,5,2,7,5,0,2,0,0,0,5,5,0,0,18,9,9,18,9,9,0,0,0,0,0,0, ,0,10,0,0
1309004014,13,9,4,14,13220,RIVERA,RIVERA,21,21,0,21,21,0,0,0,0,0,21,21,0,0,44,20,24,44,20,24,0,0,0,0,0,0, ,0,10,0,0
1309004015,13,9,4,15,13220,RIVERA,RIVERA,7,6,1,7,6,0,1,0,0,0,6,6,0,0,14,8,6,14,8,6,0,0,0,0,0,0, ,0,9,0,0
1309004016,13,9,4,16,13220,RIVERA,RIVERA,27,23,4,27,23,0,4,0,0,0,26,26,0,0,71,31,40,71,31,40,0,0,0,0,0,0, ,0,9,0,0
1309004017,13,9,4,17,13220,RIVERA,RIVERA,25,20,5,25,20,0,5,0,0,0,20,20,0,0,68,33,35,68,33,35,0,0,0,0,0,0, ,0,9,0,0
1309004018,13,9,4,18,13220,RIVERA,RIVERA,25,22,3,25,22,0,3,0,0,0,22,22,0,0,56,27,29,56,27,29,0,0,0,0,0,0, ,0,10,0,0
1309004019,13,9,4,19,13220,RIVERA,RIVERA,4,4,0,4,4,0,0,0,0,0,4,4,0,0,9,3,6,9,3,6,0,0,0,0,0,0, ,0,10,0,0
1309004020,13,9,4,20,13220,RIVERA,RIVERA,7,6,1,7,6,0,1,0,0,0,6,6,0,0,23,8,15,23,8,15,0,0,0,0,0,0, ,0,10,0,0
1309004021,13,9,4,21,13220,RIVERA,RIVERA,11,9,2,11,9,0,2,0,0,0,9,9,0,0,37,15,22,37,15,22,0,0,0,0,0,0, ,0,9,0,0
1309004024,13,9,4,24,13220,RIVERA,RIVERA,16,14,2,16,14,0,2,0,0,0,14,14,0,0,48,24,24,48,24,24,0,0,0,0,0,0, ,0,9,0,0
1309004025,13,9,4,25,13220,RIVERA,RIVERA,13,11,2,13,11,0,2,0,0,0,11,11,0,0,34,21,13,34,21,13,0,0,0,0,0,0, ,0,10,0,0
1309004027,13,9,4,27,13220,RIVERA,RIVERA,9,5,4,9,5,0,4,0,0,0,5,5,0,0,18,10,8,18,10,8,0,0,0,0,0,0, ,0,9,0,0
1309004028,13,9,4,28,13220,RIVERA,RIVERA,22,16,6,22,16,0,6,0,0,0,16,16,0,0,62,27,35,62,27,35,0,0,0,0,0,0, ,0,9,0,0
1309004035,13,9,4,35,13220,RIVERA,RIVERA,1,1,0,1,1,0,0,0,0,0,1,1,0,0,4,1,3,4,1,3,0,0,0,0,0,0, ,0,9,0,0
1309004036,13,9,4,36,13220,RIVERA,RIVERA,0,0,0,0,0,0,0,0,0,0,0,0,0,0,0,0,0,0,0,0,0,0,0,0,0,0, ,0,10,0,0
1309004038,13,9,4,38,13220,RIVERA,RIVERA,16,11,5,16,11,0,5,0,0,0,11,11,0,0,41,21,20,41,21,20,0,0,0,0,0,0, ,0,10,0,0
1309004039,13,9,4,39,13220,RIVERA,RIVERA,6,5,1,6,5,0,1,0,0,0,5,5,0,0,17,8,9,17,8,9,0,0,0,0,0,0, ,0,10,0,0
1309004040,13,9,4,40,13220,RIVERA,RIVERA,8,7,1,8,7,0,1,0,0,0,7,7,0,0,29,14,15,29,14,15,0,0,0,0,0,0, ,0,10,0,0
1309004600,13,9,4,600,13220,RIVERA,RIVERA,91,77,14,91,77,0,14,0,0,0,79,79,0,0,255,121,134,255,121,134,0,0,0,0,0,0, ,0,9,0,0
1309004601,13,9,4,601,13220,RIVERA,RIVERA,27,26,1,27,26,0,1,0,0,0,26,26,0,0,76,37,39,76,37,39,0,0,0,0,0,0, ,0,9,0,0
1309004602,13,9,4,602,13220,RIVERA,RIVERA,18,17,1,18,17,0,1,0,0,0,17,17,0,0,44,21,23,44,21,23,0,0,0,0,0,0, ,0,10,0,0
1309004603,13,9,4,603,13220,RIVERA,RIVERA,35,34,1,35,34,0,1,0,0,0,34,34,0,0,110,48,62,110,48,62,0,0,0,0,0,0, ,0,10,0,0
1309004604,13,9,4,604,13220,RIVERA,RIVERA,25,20,5,25,20,0,5,0,0,0,20,20,0,0,67,33,34,67,33,34,0,0,0,0,0,0, ,0,10,0,0
1309004605,13,9,4,605,13220,RIVERA,RIVERA,10,10,0,10,10,0,0,0,0,0,10,10,0,0,33,18,15,33,18,15,0,0,0,0,0,0, ,0,10,0,0
1309004606,13,9,4,606,13220,RIVERA,RIVERA,4,4,0,4,4,0,0,0,0,0,4,4,0,0,22,11,11,22,11,11,0,0,0,0,0,0, ,0,10,0,0
1309009002,13,9,9,2,13721,RIVERA,SANTA TERESA,49,46,3,49,46,0,3,0,0,0,48,48,0,0,165,77,88,165,77,88,0,0,0,0,0,0, ,0,10,0,0
1309009003,13,9,9,3,13721,RIVERA,SANTA TERESA,36,24,12,36,24,0,12,0,0,0,24,24,0,0,81,45,36,81,45,36,0,0,0,0,0,0, ,0,10,0,0
1309009004,13,9,9,4,13721,RIVERA,SANTA TERESA,14,14,0,14,14,0,0,0,0,0,14,14,0,0,56,26,30,56,26,30,0,0,0,0,0,0, ,0,10,0,0
1309009005,13,9,9,5,13721,RIVERA,SANTA TERESA,14,14,0,14,14,0,0,0,0,0,14,14,0,0,48,25,23,48,25,23,0,0,0,0,0,0, ,0,10,0,0
1309009006,13,9,9,6,13721,RIVERA,SANTA TERESA,12,9,3,12,9,0,3,0,0,0,9,9,0,0,30,19,11,30,19,11,0,0,0,0,0,0, ,0,10,0,0
1309009007,13,9,9,7,13721,RIVERA,SANTA TERESA,16,16,0,16,16,0,0,0,0,0,17,17,0,0,54,28,26,54,28,26,0,0,0,0,0,0, ,0,9,0,0
1309009009,13,9,9,9,13721,RIVERA,SANTA TERESA,36,31,5,36,31,0,5,0,0,0,31,31,0,0,120,63,57,120,63,57,0,0,0,0,0,0, ,0,9,0,0
1309009010,13,9,9,10,13721,RIVERA,SANTA TERESA,24,22,2,24,22,0,2,0,0,0,22,22,0,0,76,34,42,76,34,42,0,0,0,0,0,0, ,0,9,0,0
1309009011,13,9,9,11,13721,RIVERA,SANTA TERESA,25,23,2,25,23,0,2,0,0,0,23,23,0,0,66,41,25,66,41,25,0,0,0,0,0,0, ,0,9,0,0
1309009012,13,9,9,12,13721,RIVERA,SANTA TERESA,55,52,3,55,52,0,3,0,0,0,52,52,0,0,158,76,82,158,76,82,0,0,0,0,0,0, ,0,9,0,0
1309009013,13,9,9,13,13721,RIVERA,SANTA TERESA,46,44,2,46,44,0,2,0,0,0,44,44,0,0,145,61,84,145,61,84,0,0,0,0,0,0, ,0,9,0,0
1309009014,13,9,9,14,13721,RIVERA,SANTA TERESA,23,19,4,23,19,0,4,0,0,0,19,19,0,0,70,31,39,70,31,39,0,0,0,0,0,0, ,0,10,0,0
1309009016,13,9,9,16,13721,RIVERA,SANTA TERESA,47,40,7,47,40,0,7,0,0,0,40,40,0,0,142,69,73,142,69,73,0,0,0,0,0,0, ,0,10,0,0
1309009017,13,9,9,17,13721,RIVERA,SANTA TERESA,26,21,5,26,21,0,5,0,0,0,21,21,0,0,71,30,41,71,30,41,0,0,0,0,0,0, ,0,10,0,0
1309009018,13,9,9,18,13721,RIVERA,SANTA TERESA,17,15,2,17,15,0,2,0,0,0,15,15,0,0,45,25,20,45,25,20,0,0,0,0,0,0, ,0,10,0,0
1309009019,13,9,9,19,13721,RIVERA,SANTA TERESA,6,5,1,6,5,0,1,0,0,0,5,5,0,0,16,10,6,16,10,6,0,0,0,0,0,0, ,0,10,0,0
1309009020,13,9,9,20,13721,RIVERA,SANTA TERESA,12,11,1,12,11,0,1,0,0,0,13,13,0,0,29,16,13,29,16,13,0,0,0,0,0,0, ,0,10,0,0
1309009021,13,9,9,21,13721,RIVERA,SANTA TERESA,14,13,1,14,13,0,1,0,0,0,13,13,0,0,41,20,21,41,20,21,0,0,0,0,0,0, ,0,10,0,0
1309009024,13,9,9,24,13721,RIVERA,SANTA TERESA,22,15,7,22,15,0,7,0,0,0,15,15,0,0,52,28,24,52,28,24,0,0,0,0,0,0, ,0,10,0,0
1309009025,13,9,9,25,13721,RIVERA,SANTA TERESA,23,19,4,23,19,0,4,0,0,0,19,19,0,0,56,27,29,56,27,29,0,0,0,0,0,0, ,0,9,0,0
1309009026,13,9,9,26,13721,RIVERA,SANTA TERESA,27,20,7,25,18,0,7,2,2,0,20,18,0,2,110,75,35,51,28,23,0,0,0,59,47,12, ,0,9,0,0
1309009027,13,9,9,27,13721,RIVERA,SANTA TERESA,16,15,1,16,15,0,1,0,0,0,15,15,0,0,60,24,36,60,24,36,0,0,0,0,0,0, ,0,9,0,0
1309009600,13,9,9,600,13721,RIVERA,SANTA TERESA,137,107,30,137,107,0,30,0,0,0,107,107,0,0,335,169,166,335,169,166,0,0,0,0,0,0, ,0,10,0,0
1309009601,13,9,9,601,13721,RIVERA,SANTA TERESA,18,18,0,18,18,0,0,0,0,0,18,18,0,0,47,27,20,47,27,20,0,0,0,0,0,0, ,0,9,0,0
1309009602,13,9,9,602,13721,RIVERA,SANTA TERESA,19,17,2,19,17,0,2,0,0,0,19,19,0,0,64,33,31,64,33,31,0,0,0,0,0,0, ,0,9,0,0
1309010001,13,9,10,1,13837,RIVERA,MANDUBI,27,22,5,27,22,0,5,0,0,0,23,23,0,0,70,32,38,70,32,38,0,0,0,0,0,0, ,0,9,0,0
1309010002,13,9,10,2,13837,RIVERA,MANDUBI,21,20,1,21,20,0,1,0,0,0,20,20,0,0,69,36,33,69,36,33,0,0,0,0,0,0, ,0,9,0,0
1309010005,13,9,10,5,13837,RIVERA,MANDUBI,37,33,4,37,33,0,4,0,0,0,33,33,0,0,86,46,40,86,46,40,0,0,0,0,0,0, ,0,9,0,0
1309010006,13,9,10,6,13837,RIVERA,MANDUBI,60,55,5,60,55,0,5,0,0,0,55,55,0,0,195,91,104,195,91,104,0,0,0,0,0,0, ,0,9,0,0
1309010007,13,9,10,7,13837,RIVERA,MANDUBI,29,26,3,29,26,0,3,0,0,0,26,26,0,0,82,42,40,82,42,40,0,0,0,0,0,0, ,0,9,0,0
1309010008,13,9,10,8,13837,RIVERA,MANDUBI,60,57,3,60,57,0,3,0,0,0,57,57,0,0,196,100,96,196,100,96,0,0,0,0,0,0, ,0,9,0,0
1309010009,13,9,10,9,13837,RIVERA,MANDUBI,50,47,3,50,47,0,3,0,0,0,47,47,0,0,205,97,108,205,97,108,0,0,0,0,0,0, ,0,9,0,0
1309010010,13,9,10,10,13837,RIVERA,MANDUBI,28,22,6,28,22,0,6,0,0,0,22,22,0,0,80,40,40,80,40,40,0,0,0,0,0,0, ,0,9,0,0
1309010011,13,9,10,11,13837,RIVERA,MANDUBI,50,48,2,50,48,0,2,0,0,0,48,48,0,0,162,80,82,162,80,82,0,0,0,0,0,0, ,0,9,0,0
1309010013,13,9,10,13,13837,RIVERA,MANDUBI,49,45,4,49,45,0,4,0,0,0,45,45,0,0,148,81,67,148,81,67,0,0,0,0,0,0, ,0,9,0,0
1309010014,13,9,10,14,13837,RIVERA,MANDUBI,29,26,3,29,26,0,3,0,0,0,27,27,0,0,86,43,43,86,43,43,0,0,0,0,0,0, ,0,9,0,0
1309010015,13,9,10,15,13837,RIVERA,MANDUBI,27,25,2,27,25,0,2,0,0,0,25,25,0,0,74,33,41,74,33,41,0,0,0,0,0,0, ,0,9,0,0
1309010016,13,9,10,16,13837,RIVERA,MANDUBI,31,31,0,31,31,0,0,0,0,0,31,31,0,0,92,51,41,92,51,41,0,0,0,0,0,0, ,0,9,0,0
1309010018,13,9,10,18,13837,RIVERA,MANDUBI,28,25,3,28,25,0,3,0,0,0,25,25,0,0,98,42,56,98,42,56,0,0,0,0,0,0, ,0,9,0,0
1309010019,13,9,10,19,13837,RIVERA,MANDUBI,25,22,3,25,22,0,3,0,0,0,22,22,0,0,68,38,30,68,38,30,0,0,0,0,0,0, ,0,9,0,0
1309010020,13,9,10,20,13837,RIVERA,MANDUBI,47,47,0,47,47,0,0,0,0,0,47,47,0,0,143,72,71,143,72,71,0,0,0,0,0,0, ,0,9,0,0
1309010024,13,9,10,24,13837,RIVERA,MANDUBI,12,12,0,12,12,0,0,0,0,0,12,12,0,0,28,11,17,28,11,17,0,0,0,0,0,0, ,0,9,0,0
1309010025,13,9,10,25,13837,RIVERA,MANDUBI,34,33,1,34,33,0,1,0,0,0,35,35,0,0,141,77,64,141,77,64,0,0,0,0,0,0, ,0,9,0,0
1309010026,13,9,10,26,13837,RIVERA,MANDUBI,23,19,4,23,19,0,4,0,0,0,19,19,0,0,53,22,31,53,22,31,0,0,0,0,0,0, ,0,9,0,0
1309010027,13,9,10,27,13837,RIVERA,MANDUBI,36,30,6,36,30,0,6,0,0,0,30,30,0,0,100,54,46,100,54,46,0,0,0,0,0,0, ,0,9,0,0
1309010031,13,9,10,31,13837,RIVERA,MANDUBI,26,26,0,26,26,0,0,0,0,0,26,26,0,0,108,52,56,108,52,56,0,0,0,0,0,0, ,0,9,0,0
1309010032,13,9,10,32,13837,RIVERA,MANDUBI,27,24,3,27,24,0,3,0,0,0,24,24,0,0,59,29,30,59,29,30,0,0,0,0,0,0, ,0,9,0,0
1309010033,13,9,10,33,13837,RIVERA,MANDUBI,8,7,1,8,7,0,1,0,0,0,8,8,0,0,28,15,13,28,15,13,0,0,0,0,0,0, ,0,9,0,0
1309010034,13,9,10,34,13837,RIVERA,MANDUBI,13,12,1,13,12,0,1,0,0,0,12,12,0,0,35,18,17,35,18,17,0,0,0,0,0,0, ,0,9,0,0
1309010035,13,9,10,35,13837,RIVERA,MANDUBI,20,19,1,20,19,0,1,0,0,0,19,19,0,0,53,26,27,53,26,27,0,0,0,0,0,0, ,0,9,0,0
1309010036,13,9,10,36,13837,RIVERA,MANDUBI,25,23,2,25,23,0,2,0,0,0,23,23,0,0,75,38,37,75,38,37,0,0,0,0,0,0, ,0,9,0,0
1309010037,13,9,10,37,13837,RIVERA,MANDUBI,53,53,0,53,53,0,0,0,0,0,53,53,0,0,172,83,89,172,83,89,0,0,0,0,0,0, ,0,9,0,0
1309010038,13,9,10,38,13837,RIVERA,MANDUBI,39,38,1,39,38,0,1,0,0,0,40,40,0,0,144,65,79,144,65,79,0,0,0,0,0,0, ,0,9,0,0
1309010039,13,9,10,39,13837,RIVERA,MANDUBI,44,41,3,44,41,0,3,0,0,0,42,42,0,0,160,73,87,160,73,87,0,0,0,0,0,0, ,0,9,0,0
1309010040,13,9,10,40,13837,RIVERA,MANDUBI,33,28,5,33,28,0,5,0,0,0,28,28,0,0,88,44,44,88,44,44,0,0,0,0,0,0, ,0,9,0,0
1309010041,13,9,10,41,13837,RIVERA,MANDUBI,37,34,3,37,34,0,3,0,0,0,34,34,0,0,146,69,77,146,69,77,0,0,0,0,0,0, ,0,9,0,0
1309010042,13,9,10,42,13837,RIVERA,MANDUBI,13,12,1,13,12,0,1,0,0,0,12,12,0,0,41,21,20,41,21,20,0,0,0,0,0,0, ,0,9,0,0
1309010043,13,9,10,43,13837,RIVERA,MANDUBI,25,24,1,25,24,0,1,0,0,0,24,24,0,0,73,32,41,73,32,41,0,0,0,0,0,0, ,0,9,0,0
1309010045,13,9,10,45,13837,RIVERA,MANDUBI,27,27,0,27,27,0,0,0,0,0,27,27,0,0,75,36,39,75,36,39,0,0,0,0,0,0, ,0,9,0,0
1309010046,13,9,10,46,13837,RIVERA,MANDUBI,15,13,2,15,13,0,2,0,0,0,13,13,0,0,53,32,21,53,32,21,0,0,0,0,0,0, ,0,9,0,0
1309010047,13,9,10,47,13837,RIVERA,MANDUBI,7,5,2,7,5,0,2,0,0,0,5,5,0,0,17,8,9,17,8,9,0,0,0,0,0,0, ,0,9,0,0
1309010049,13,9,10,49,13837,RIVERA,MANDUBI,10,9,1,10,9,0,1,0,0,0,9,9,0,0,29,13,16,29,13,16,0,0,0,0,0,0, ,0,9,0,0
1309010051,13,9,10,51,13837,RIVERA,MANDUBI,15,13,2,15,13,0,2,0,0,0,13,13,0,0,37,18,19,37,18,19,0,0,0,0,0,0, ,0,9,0,0
1309010052,13,9,10,52,13837,RIVERA,MANDUBI,29,25,4,29,25,0,4,0,0,0,25,25,0,0,97,50,47,97,50,47,0,0,0,0,0,0, ,0,9,0,0
1309010053,13,9,10,53,13837,RIVERA,MANDUBI,55,50,5,55,50,0,5,0,0,0,50,50,0,0,174,91,83,174,91,83,0,0,0,0,0,0, ,0,9,0,0
1309010056,13,9,10,56,13837,RIVERA,MANDUBI,22,20,2,22,20,0,2,0,0,0,20,20,0,0,78,46,32,78,46,32,0,0,0,0,0,0, ,0,9,0,0
1309010057,13,9,10,57,13837,RIVERA,MANDUBI,33,29,4,33,29,0,4,0,0,0,29,29,0,0,85,38,47,85,38,47,0,0,0,0,0,0, ,0,9,0,0
1309010058,13,9,10,58,13837,RIVERA,MANDUBI,24,22,2,24,22,0,2,0,0,0,23,23,0,0,67,32,35,67,32,35,0,0,0,0,0,0, ,0,9,0,0
1309010059,13,9,10,59,13837,RIVERA,MANDUBI,17,14,3,17,14,0,3,0,0,0,14,14,0,0,38,23,15,38,23,15,0,0,0,0,0,0, ,0,9,0,0
1309010060,13,9,10,60,13837,RIVERA,MANDUBI,7,7,0,7,7,0,0,0,0,0,7,7,0,0,21,13,8,21,13,8,0,0,0,0,0,0, ,0,9,0,0
1309010063,13,9,10,63,13837,RIVERA,MANDUBI,26,24,2,26,24,0,2,0,0,0,24,24,0,0,91,46,45,91,46,45,0,0,0,0,0,0, ,0,9,0,0
1309010064,13,9,10,64,13837,RIVERA,MANDUBI,21,20,1,21,20,0,1,0,0,0,20,20,0,0,69,33,36,69,33,36,0,0,0,0,0,0, ,0,9,0,0
1309010065,13,9,10,65,13837,RIVERA,MANDUBI,0,0,0,0,0,0,0,0,0,0,0,0,0,0,0,0,0,0,0,0,0,0,0,0,0,0, ,0,9,0,0
1309010400,13,9,10,400,13837,RIVERA,MANDUBI,0,0,0,0,0,0,0,0,0,0,0,0,0,0,0,0,0,0,0,0,0,0,0,0,0,0, ,0,9,0,0
1309010600,13,9,10,600,13837,RIVERA,MANDUBI,72,68,4,72,68,0,4,0,0,0,68,68,0,0,234,117,117,234,117,117,0,0,0,0,0,0, ,0,9,0,0
1309010601,13,9,10,601,13837,RIVERA,MANDUBI,2,2,0,2,2,0,0,0,0,0,2,2,0,0,5,1,4,5,1,4,0,0,0,0,0,0, ,0,9,0,0
1309010602,13,9,10,602,13837,RIVERA,MANDUBI,9,7,2,9,7,0,2,0,0,0,7,7,0,0,19,9,10,19,9,10,0,0,0,0,0,0, ,0,9,0,0
1309010603,13,9,10,603,13837,RIVERA,MANDUBI,10,10,0,10,10,0,0,0,0,0,10,10,0,0,50,31,19,50,31,19,0,0,0,0,0,0, ,0,9,0,0
1309010606,13,9,10,606,13837,RIVERA,MANDUBI,68,56,12,68,56,0,12,0,0,0,59,59,0,0,213,103,110,213,103,110,0,0,0,0,0,0, ,0,9,0,0
1309010607,13,9,10,607,13837,RIVERA,MANDUBI,12,8,4,12,8,0,4,0,0,0,8,8,0,0,27,14,13,27,14,13,0,0,0,0,0,0, ,0,9,0,0
1309010608,13,9,10,608,13837,RIVERA,MANDUBI,5,5,0,5,5,0,0,0,0,0,5,5,0,0,15,8,7,15,8,7,0,0,0,0,0,0, ,0,9,0,0
1309010609,13,9,10,609,13837,RIVERA,MANDUBI,24,22,2,24,22,0,2,0,0,0,22,22,0,0,69,38,31,69,38,31,0,0,0,0,0,0, ,0,9,0,0
1309010610,13,9,10,610,13837,RIVERA,MANDUBI,11,11,0,11,11,0,0,0,0,0,11,11,0,0,54,24,30,54,24,30,0,0,0,0,0,0, ,0,9,0,0
1309010611,13,9,10,611,13837,RIVERA,MANDUBI,8,8,0,8,8,0,0,0,0,0,8,8,0,0,33,20,13,33,20,13,0,0,0,0,0,0, ,0,9,0,0
1309010612,13,9,10,612,13837,RIVERA,MANDUBI,6,6,0,6,6,0,0,0,0,0,6,6,0,0,22,9,13,22,9,13,0,0,0,0,0,0, ,0,9,0,0
1309010613,13,9,10,613,13837,RIVERA,MANDUBI,11,11,0,11,11,0,0,0,0,0,12,12,0,0,43,25,18,43,25,18,0,0,0,0,0,0, ,0,9,0,0
1309010614,13,9,10,614,13837,RIVERA,MANDUBI,0,0,0,0,0,0,0,0,0,0,0,0,0,0,0,0,0,0,0,0,0,0,0,0,0,0, ,0,9,0,0
1309010615,13,9,10,615,13837,RIVERA,MANDUBI,10,10,0,10,10,0,0,0,0,0,10,10,0,0,53,23,30,53,23,30,0,0,0,0,0,0, ,0,9,0,0
1309010616,13,9,10,616,13837,RIVERA,MANDUBI,0,0,0,0,0,0,0,0,0,0,0,0,0,0,0,0,0,0,0,0,0,0,0,0,0,0, ,0,9,0,0
1309010617,13,9,10,617,13837,RIVERA,MANDUBI,16,16,0,16,16,0,0,0,0,0,16,16,0,0,68,35,33,68,35,33,0,0,0,0,0,0, ,0,9,0,0
1309010618,13,9,10,618,13837,RIVERA,MANDUBI,7,7,0,7,7,0,0,0,0,0,7,7,0,0,26,12,14,26,12,14,0,0,0,0,0,0, ,0,9,0,0
1309010619,13,9,10,619,13837,RIVERA,MANDUBI,2,2,0,2,2,0,0,0,0,0,2,2,0,0,10,4,6,10,4,6,0,0,0,0,0,0, ,0,9,0,0
1309010620,13,9,10,620,13837,RIVERA,MANDUBI,15,15,0,15,15,0,0,0,0,0,15,15,0,0,62,36,26,62,36,26,0,0,0,0,0,0, ,0,9,0,0
1309010621,13,9,10,621,13837,RIVERA,MANDUBI,5,5,0,5,5,0,0,0,0,0,5,5,0,0,17,9,8,17,9,8,0,0,0,0,0,0, ,0,9,0,0
1309010624,13,9,10,624,13837,RIVERA,MANDUBI,63,58,5,63,58,0,5,0,0,0,61,61,0,0,206,108,98,206,108,98,0,0,0,0,0,0, ,0,9,0,0
1309010625,13,9,10,625,13837,RIVERA,MANDUBI,52,48,4,52,48,0,4,0,0,0,48,48,0,0,164,74,90,164,74,90,0,0,0,0,0,0, ,0,9,0,0
1309010700,13,9,10,700,13837,RIVERA,MANDUBI,11,11,0,11,11,0,0,0,0,0,11,11,0,0,35,12,23,35,12,23,0,0,0,0,0,0, ,0,9,0,0
1309010701,13,9,10,701,13837,RIVERA,MANDUBI,3,3,0,3,3,0,0,0,0,0,3,3,0,0,10,5,5,10,5,5,0,0,0,0,0,0, ,0,9,0,0
1309010702,13,9,10,702,13837,RIVERA,MANDUBI,1,1,0,1,1,0,0,0,0,0,1,1,0,0,4,3,1,4,3,1,0,0,0,0,0,0, ,0,9,0,0
1309010801,13,9,10,801,13837,RIVERA,MANDUBI,17,17,0,17,17,0,0,0,0,0,17,17,0,0,63,38,25,63,38,25,0,0,0,0,0,0, ,0,9,0,0
1309010802,13,9,10,802,13837,RIVERA,MANDUBI,12,11,1,12,11,0,1,0,0,0,11,11,0,0,33,18,15,33,18,15,0,0,0,0,0,0, ,0,9,0,0
1309010803,13,9,10,803,13837,RIVERA,MANDUBI,20,17,3,20,17,0,3,0,0,0,17,17,0,0,55,23,32,55,23,32,0,0,0,0,0,0, ,0,9,0,0
1309010807,13,9,10,807,13837,RIVERA,MANDUBI,23,20,3,23,20,0,3,0,0,0,20,20,0,0,98,50,48,98,50,48,0,0,0,0,0,0, ,0,9,0,0
1309011002,13,9,11,2,13836,RIVERA,LA PEDRERA,31,27,4,31,27,0,4,0,0,0,27,27,0,0,75,36,39,75,36,39,0,0,0,0,0,0, ,0,9,0,0
1309011003,13,9,11,3,13836,RIVERA,LA PEDRERA,34,29,5,34,29,0,5,0,0,0,29,29,0,0,100,48,52,100,48,52,0,0,0,0,0,0, ,0,9,0,0
1309011004,13,9,11,4,13836,RIVERA,LA PEDRERA,45,40,5,45,40,0,5,0,0,0,40,40,0,0,112,57,55,112,57,55,0,0,0,0,0,0, ,0,9,0,0
1309011005,13,9,11,5,13836,RIVERA,LA PEDRERA,30,27,3,30,27,0,3,0,0,0,27,27,0,0,113,50,63,113,50,63,0,0,0,0,0,0, ,0,9,0,0
1309011007,13,9,11,7,13836,RIVERA,LA PEDRERA,27,25,2,27,25,0,2,0,0,0,26,26,0,0,70,29,41,70,29,41,0,0,0,0,0,0, ,0,9,0,0
1309011008,13,9,11,8,13836,RIVERA,LA PEDRERA,33,29,4,33,29,0,4,0,0,0,29,29,0,0,92,49,43,92,49,43,0,0,0,0,0,0, ,0,9,0,0
1309011009,13,9,11,9,13836,RIVERA,LA PEDRERA,26,22,4,26,22,0,4,0,0,0,22,22,0,0,64,31,33,64,31,33,0,0,0,0,0,0, ,0,9,0,0
1309011010,13,9,11,10,13836,RIVERA,LA PEDRERA,32,29,3,32,29,0,3,0,0,0,29,29,0,0,88,41,47,88,41,47,0,0,0,0,0,0, ,0,9,0,0
1309011011,13,9,11,11,13836,RIVERA,LA PEDRERA,24,24,0,24,24,0,0,0,0,0,25,25,0,0,74,37,37,74,37,37,0,0,0,0,0,0, ,0,9,0,0
1309011013,13,9,11,13,13836,RIVERA,LA PEDRERA,21,19,2,21,19,0,2,0,0,0,19,19,0,0,53,27,26,53,27,26,0,0,0,0,0,0, ,0,9,0,0
1309011014,13,9,11,14,13836,RIVERA,LA PEDRERA,18,15,3,18,15,0,3,0,0,0,15,15,0,0,44,23,21,44,23,21,0,0,0,0,0,0, ,0,9,0,0
1309011015,13,9,11,15,13836,RIVERA,LA PEDRERA,17,14,3,17,14,0,3,0,0,0,14,14,0,0,41,22,19,41,22,19,0,0,0,0,0,0, ,0,9,0,0
1309011016,13,9,11,16,13836,RIVERA,LA PEDRERA,41,38,3,41,38,0,3,0,0,0,38,38,0,0,111,56,55,111,56,55,0,0,0,0,0,0, ,0,9,0,0
1309011017,13,9,11,17,13836,RIVERA,LA PEDRERA,49,46,3,49,46,0,3,0,0,0,46,46,0,0,138,70,68,138,70,68,0,0,0,0,0,0, ,0,9,0,0
1309011019,13,9,11,19,13836,RIVERA,LA PEDRERA,18,13,5,18,13,0,5,0,0,0,13,13,0,0,54,29,25,54,29,25,0,0,0,0,0,0, ,0,9,0,0
1309011020,13,9,11,20,13836,RIVERA,LA PEDRERA,17,16,1,17,16,0,1,0,0,0,16,16,0,0,52,30,22,52,30,22,0,0,0,0,0,0, ,0,9,0,0
1309011021,13,9,11,21,13836,RIVERA,LA PEDRERA,30,29,1,30,29,0,1,0,0,0,29,29,0,0,83,41,42,83,41,42,0,0,0,0,0,0, ,0,9,0,0
1309011022,13,9,11,22,13836,RIVERA,LA PEDRERA,18,16,2,18,16,0,2,0,0,0,18,18,0,0,55,25,30,55,25,30,0,0,0,0,0,0, ,0,9,0,0
1309011023,13,9,11,23,13836,RIVERA,LA PEDRERA,14,12,2,14,12,0,2,0,0,0,12,12,0,0,45,19,26,45,19,26,0,0,0,0,0,0, ,0,9,0,0
1309011024,13,9,11,24,13836,RIVERA,LA PEDRERA,21,18,3,21,18,0,3,0,0,0,18,18,0,0,71,32,39,71,32,39,0,0,0,0,0,0, ,0,9,0,0
1309011025,13,9,11,25,13836,RIVERA,LA PEDRERA,21,17,4,21,17,0,4,0,0,0,17,17,0,0,54,27,27,54,27,27,0,0,0,0,0,0, ,0,9,0,0
1309011026,13,9,11,26,13836,RIVERA,LA PEDRERA,21,20,1,21,20,0,1,0,0,0,20,20,0,0,79,36,43,79,36,43,0,0,0,0,0,0, ,0,9,0,0
1309011027,13,9,11,27,13836,RIVERA,LA PEDRERA,19,18,1,19,18,0,1,0,0,0,18,18,0,0,48,21,27,48,21,27,0,0,0,0,0,0, ,0,9,0,0
1309011029,13,9,11,29,13836,RIVERA,LA PEDRERA,27,25,2,27,25,0,2,0,0,0,25,25,0,0,78,39,39,78,39,39,0,0,0,0,0,0, ,0,9,0,0
1309011030,13,9,11,30,13836,RIVERA,LA PEDRERA,11,9,2,11,9,0,2,0,0,0,9,9,0,0,34,18,16,34,18,16,0,0,0,0,0,0, ,0,9,0,0
1309011031,13,9,11,31,13836,RIVERA,LA PEDRERA,13,12,1,13,12,0,1,0,0,0,12,12,0,0,36,17,19,36,17,19,0,0,0,0,0,0, ,0,9,0,0
1309011032,13,9,11,32,13836,RIVERA,LA PEDRERA,1,1,0,1,1,0,0,0,0,0,1,1,0,0,2,0,2,2,0,2,0,0,0,0,0,0, ,0,9,0,0
1309011033,13,9,11,33,13836,RIVERA,LA PEDRERA,19,15,4,19,15,0,4,0,0,0,15,15,0,0,58,25,33,58,25,33,0,0,0,0,0,0, ,0,9,0,0
1309011034,13,9,11,34,13836,RIVERA,LA PEDRERA,17,17,0,17,17,0,0,0,0,0,17,17,0,0,60,25,35,60,25,35,0,0,0,0,0,0, ,0,9,0,0
1309011036,13,9,11,36,13836,RIVERA,LA PEDRERA,30,30,0,30,30,0,0,0,0,0,30,30,0,0,112,57,55,112,57,55,0,0,0,0,0,0, ,0,9,0,0
1309011037,13,9,11,37,13836,RIVERA,LA PEDRERA,63,37,26,63,37,0,26,0,0,0,37,37,0,0,99,48,51,99,48,51,0,0,0,0,0,0, ,0,9,0,0
1309011040,13,9,11,40,13836,RIVERA,LA PEDRERA,20,18,2,20,18,0,2,0,0,0,18,18,0,0,49,20,29,49,20,29,0,0,0,0,0,0, ,0,9,0,0
1309011042,13,9,11,42,13836,RIVERA,LA PEDRERA,28,23,5,28,23,0,5,0,0,0,23,23,0,0,66,35,31,66,35,31,0,0,0,0,0,0, ,0,9,0,0
1309011044,13,9,11,44,13836,RIVERA,LA PEDRERA,8,8,0,7,7,0,0,1,1,0,9,8,0,1,90,14,76,25,14,11,0,0,0,65,0,65, ,0,9,0,0
1309011045,13,9,11,45,13836,RIVERA,LA PEDRERA,15,13,2,15,13,0,2,0,0,0,13,13,0,0,44,21,23,44,21,23,0,0,0,0,0,0, ,0,9,0,0
1309011046,13,9,11,46,13836,RIVERA,LA PEDRERA,18,15,3,18,15,0,3,0,0,0,15,15,0,0,63,32,31,63,32,31,0,0,0,0,0,0, ,0,9,0,0
1309011047,13,9,11,47,13836,RIVERA,LA PEDRERA,11,10,1,11,10,0,1,0,0,0,10,10,0,0,28,17,11,28,17,11,0,0,0,0,0,0, ,0,9,0,0
1309011400,13,9,11,400,13836,RIVERA,LA PEDRERA,0,0,0,0,0,0,0,0,0,0,0,0,0,0,0,0,0,0,0,0,0,0,0,0,0,0, ,0,9,0,0
1309011401,13,9,11,401,13836,RIVERA,LA PEDRERA,0,0,0,0,0,0,0,0,0,0,0,0,0,0,0,0,0,0,0,0,0,0,0,0,0,0, ,0,9,0,0
1309011402,13,9,11,402,13836,RIVERA,LA PEDRERA,0,0,0,0,0,0,0,0,0,0,0,0,0,0,0,0,0,0,0,0,0,0,0,0,0,0, ,0,9,0,0
1309011403,13,9,11,403,13836,RIVERA,LA PEDRERA,0,0,0,0,0,0,0,0,0,0,0,0,0,0,0,0,0,0,0,0,0,0,0,0,0,0, ,0,9,0,0
1309011404,13,9,11,404,13836,RIVERA,LA PEDRERA,0,0,0,0,0,0,0,0,0,0,0,0,0,0,0,0,0,0,0,0,0,0,0,0,0,0, ,0,9,0,0
1309011405,13,9,11,405,13836,RIVERA,LA PEDRERA,0,0,0,0,0,0,0,0,0,0,0,0,0,0,0,0,0,0,0,0,0,0,0,0,0,0, ,0,9,0,0
1309011406,13,9,11,406,13836,RIVERA,LA PEDRERA,0,0,0,0,0,0,0,0,0,0,0,0,0,0,0,0,0,0,0,0,0,0,0,0,0,0, ,0,9,0,0
1309011407,13,9,11,407,13836,RIVERA,LA PEDRERA,0,0,0,0,0,0,0,0,0,0,0,0,0,0,0,0,0,0,0,0,0,0,0,0,0,0, ,0,9,0,0
1309011408,13,9,11,408,13836,RIVERA,LA PEDRERA,0,0,0,0,0,0,0,0,0,0,0,0,0,0,0,0,0,0,0,0,0,0,0,0,0,0, ,0,9,0,0
1309011409,13,9,11,409,13836,RIVERA,LA PEDRERA,0,0,0,0,0,0,0,0,0,0,0,0,0,0,0,0,0,0,0,0,0,0,0,0,0,0, ,0,9,0,0
1309011410,13,9,11,410,13836,RIVERA,LA PEDRERA,0,0,0,0,0,0,0,0,0,0,0,0,0,0,0,0,0,0,0,0,0,0,0,0,0,0, ,0,9,0,0
1309011411,13,9,11,411,13836,RIVERA,LA PEDRERA,0,0,0,0,0,0,0,0,0,0,0,0,0,0,0,0,0,0,0,0,0,0,0,0,0,0, ,0,9,0,0
1309011412,13,9,11,412,13836,RIVERA,LA PEDRERA,0,0,0,0,0,0,0,0,0,0,0,0,0,0,0,0,0,0,0,0,0,0,0,0,0,0, ,0,9,0,0
1309011413,13,9,11,413,13836,RIVERA,LA PEDRERA,0,0,0,0,0,0,0,0,0,0,0,0,0,0,0,0,0,0,0,0,0,0,0,0,0,0, ,0,9,0,0
1309011414,13,9,11,414,13836,RIVERA,LA PEDRERA,0,0,0,0,0,0,0,0,0,0,0,0,0,0,0,0,0,0,0,0,0,0,0,0,0,0, ,0,9,0,0
1309011415,13,9,11,415,13836,RIVERA,LA PEDRERA,0,0,0,0,0,0,0,0,0,0,0,0,0,0,0,0,0,0,0,0,0,0,0,0,0,0, ,0,9,0,0
1309011416,13,9,11,416,13836,RIVERA,LA PEDRERA,0,0,0,0,0,0,0,0,0,0,0,0,0,0,0,0,0,0,0,0,0,0,0,0,0,0, ,0,9,0,0
1309011417,13,9,11,417,13836,RIVERA,LA PEDRERA,0,0,0,0,0,0,0,0,0,0,0,0,0,0,0,0,0,0,0,0,0,0,0,0,0,0, ,0,9,0,0
1309011501,13,9,11,501,13836,RIVERA,LA PEDRERA,0,0,0,0,0,0,0,0,0,0,0,0,0,0,0,0,0,0,0,0,0,0,0,0,0,0, ,0,9,0,0
1309011503,13,9,11,503,13836,RIVERA,LA PEDRERA,0,0,0,0,0,0,0,0,0,0,0,0,0,0,0,0,0,0,0,0,0,0,0,0,0,0, ,0,9,0,0
1309011602,13,9,11,602,13836,RIVERA,LA PEDRERA,5,5,0,5,5,0,0,0,0,0,5,5,0,0,18,8,10,18,8,10,0,0,0,0,0,0, ,0,9,0,0
1309011603,13,9,11,603,13836,RIVERA,LA PEDRERA,1,1,0,1,1,0,0,0,0,0,1,1,0,0,2,1,1,2,1,1,0,0,0,0,0,0, ,0,9,0,0
1309011604,13,9,11,604,13836,RIVERA,LA PEDRERA,2,2,0,2,2,0,0,0,0,0,2,2,0,0,2,1,1,2,1,1,0,0,0,0,0,0, ,0,9,0,0
1309011605,13,9,11,605,13836,RIVERA,LA PEDRERA,0,0,0,0,0,0,0,0,0,0,0,0,0,0,0,0,0,0,0,0,0,0,0,0,0,0, ,0,9,0,0
1309011621,13,9,11,621,13836,RIVERA,LA PEDRERA,31,27,4,31,27,0,4,0,0,0,27,27,0,0,79,34,45,79,34,45,0,0,0,0,0,0, ,0,9,0,0
1309011700,13,9,11,700,13836,RIVERA,LA PEDRERA,28,26,2,28,26,0,2,0,0,0,26,26,0,0,91,48,43,91,48,43,0,0,0,0,0,0, ,0,9,0,0
1309011701,13,9,11,701,13836,RIVERA,LA PEDRERA,19,17,2,19,17,0,2,0,0,0,18,18,0,0,52,31,21,52,31,21,0,0,0,0,0,0, ,0,9,0,0
1309011702,13,9,11,702,13836,RIVERA,LA PEDRERA,14,12,2,14,12,0,2,0,0,0,13,13,0,0,45,22,23,45,22,23,0,0,0,0,0,0, ,0,9,0,0
1309011703,13,9,11,703,13836,RIVERA,LA PEDRERA,5,4,1,5,4,0,1,0,0,0,4,4,0,0,14,8,6,14,8,6,0,0,0,0,0,0, ,0,9,0,0
1309011704,13,9,11,704,13836,RIVERA,LA PEDRERA,41,38,3,41,38,0,3,0,0,0,39,39,0,0,115,58,57,115,58,57,0,0,0,0,0,0, ,0,9,0,0
1309011705,13,9,11,705,13836,RIVERA,LA PEDRERA,0,0,0,0,0,0,0,0,0,0,0,0,0,0,0,0,0,0,0,0,0,0,0,0,0,0, ,0,9,0,0
1309011706,13,9,11,706,13836,RIVERA,LA PEDRERA,11,7,4,11,7,0,4,0,0,0,7,7,0,0,30,16,14,30,16,14,0,0,0,0,0,0, ,0,9,0,0
1309011707,13,9,11,707,13836,RIVERA,LA PEDRERA,12,10,2,12,10,0,2,0,0,0,10,10,0,0,30,16,14,30,16,14,0,0,0,0,0,0, ,0,9,0,0
1309011803,13,9,11,803,13836,RIVERA,LA PEDRERA,15,10,5,15,10,0,5,0,0,0,10,10,0,0,31,16,15,31,16,15,0,0,0,0,0,0, ,0,9,0,0
1309011804,13,9,11,804,13836,RIVERA,LA PEDRERA,28,25,3,28,25,0,3,0,0,0,25,25,0,0,71,40,31,71,40,31,0,0,0,0,0,0, ,0,9,0,0
1309011806,13,9,11,806,13836,RIVERA,LA PEDRERA,10,7,3,10,7,0,3,0,0,0,7,7,0,0,19,9,10,19,9,10,0,0,0,0,0,0, ,0,9,0,0
1309011807,13,9,11,807,13836,RIVERA,LA PEDRERA,57,54,3,57,54,0,3,0,0,0,54,54,0,0,154,80,74,154,80,74,0,0,0,0,0,0, ,0,9,0,0
1309103003,13,9,103,3,13220,RIVERA,RIVERA,34,31,3,34,31,0,3,0,0,0,32,32,0,0,120,59,61,120,59,61,0,0,0,0,0,0, ,0,10,0,0
1309103006,13,9,103,6,13220,RIVERA,RIVERA,25,22,3,25,22,0,3,0,0,0,22,22,0,0,75,41,34,75,41,34,0,0,0,0,0,0, ,0,10,0,0
1309103007,13,9,103,7,13220,RIVERA,RIVERA,20,19,1,20,19,0,1,0,0,0,19,19,0,0,62,28,34,62,28,34,0,0,0,0,0,0, ,0,10,0,0
1309103009,13,9,103,9,13220,RIVERA,RIVERA,18,10,8,18,10,0,8,0,0,0,10,10,0,0,34,13,21,34,13,21,0,0,0,0,0,0, ,0,10,0,0
1309103010,13,9,103,10,13220,RIVERA,RIVERA,24,21,3,24,21,0,3,0,0,0,27,27,0,0,95,46,49,95,46,49,0,0,0,0,0,0, ,0,10,0,0
1309103011,13,9,103,11,13220,RIVERA,RIVERA,29,28,1,29,28,0,1,0,0,0,28,28,0,0,87,43,44,87,43,44,0,0,0,0,0,0, ,0,10,0,0
1309103012,13,9,103,12,13220,RIVERA,RIVERA,39,38,1,39,38,0,1,0,0,0,40,40,0,0,124,63,61,124,63,61,0,0,0,0,0,0, ,0,10,0,0
1309103013,13,9,103,13,13220,RIVERA,RIVERA,15,14,1,15,14,0,1,0,0,0,14,14,0,0,42,15,27,42,15,27,0,0,0,0,0,0, ,0,10,0,0
1309103015,13,9,103,15,13220,RIVERA,RIVERA,28,23,5,28,23,0,5,0,0,0,23,23,0,0,72,36,36,72,36,36,0,0,0,0,0,0, ,0,10,0,0
1309103016,13,9,103,16,13220,RIVERA,RIVERA,29,26,3,29,26,0,3,0,0,0,26,26,0,0,70,33,37,70,33,37,0,0,0,0,0,0, ,0,10,0,0
1309103017,13,9,103,17,13220,RIVERA,RIVERA,23,20,3,23,20,0,3,0,0,0,20,20,0,0,59,34,25,59,34,25,0,0,0,0,0,0, ,0,10,0,0
1309103018,13,9,103,18,13220,RIVERA,RIVERA,12,11,1,12,11,0,1,0,0,0,11,11,0,0,36,17,19,36,17,19,0,0,0,0,0,0, ,0,10,0,0
1309103031,13,9,103,31,13220,RIVERA,RIVERA,41,39,2,41,39,0,2,0,0,0,39,39,0,0,137,68,69,137,68,69,0,0,0,0,0,0, ,0,10,0,0
1309103032,13,9,103,32,13220,RIVERA,RIVERA,0,0,0,0,0,0,0,0,0,0,0,0,0,0,0,0,0,0,0,0,0,0,0,0,0,0, ,0,10,0,0
1309103034,13,9,103,34,13220,RIVERA,RIVERA,20,19,1,20,19,0,1,0,0,0,19,19,0,0,72,28,44,72,28,44,0,0,0,0,0,0, ,0,10,0,0
1309103036,13,9,103,36,13220,RIVERA,RIVERA,16,15,1,16,15,0,1,0,0,0,15,15,0,0,50,29,21,50,29,21,0,0,0,0,0,0, ,0,10,0,0
1309103038,13,9,103,38,13220,RIVERA,RIVERA,19,18,1,19,18,0,1,0,0,0,18,18,0,0,55,22,33,55,22,33,0,0,0,0,0,0, ,0,10,0,0
1309103053,13,9,103,53,13220,RIVERA,RIVERA,13,10,3,13,10,0,3,0,0,0,10,10,0,0,31,14,17,31,14,17,0,0,0,0,0,0, ,0,10,0,0
1309103057,13,9,103,57,13220,RIVERA,RIVERA,6,5,1,6,5,0,1,0,0,0,5,5,0,0,19,11,8,19,11,8,0,0,0,0,0,0, ,0,10,0,0
1309103400,13,9,103,400,13220,RIVERA,RIVERA,0,0,0,0,0,0,0,0,0,0,0,0,0,0,0,0,0,0,0,0,0,0,0,0,0,0, ,0,10,0,0
1309103401,13,9,103,401,13220,RIVERA,RIVERA,0,0,0,0,0,0,0,0,0,0,0,0,0,0,0,0,0,0,0,0,0,0,0,0,0,0, ,0,10,0,0
1309103600,13,9,103,600,13220,RIVERA,RIVERA,49,47,2,49,47,0,2,0,0,0,47,47,0,0,201,99,102,201,99,102,0,0,0,0,0,0, ,0,10,0,0
1309103601,13,9,103,601,13220,RIVERA,RIVERA,9,7,2,9,7,0,2,0,0,0,7,7,0,0,19,8,11,19,8,11,0,0,0,0,0,0, ,0,10,0,0
1309103603,13,9,103,603,13220,RIVERA,RIVERA,13,12,1,13,12,0,1,0,0,0,12,12,0,0,34,14,20,34,14,20,0,0,0,0,0,0, ,0,10,0,0
1309103604,13,9,103,604,13220,RIVERA,RIVERA,0,0,0,0,0,0,0,0,0,0,0,0,0,0,0,0,0,0,0,0,0,0,0,0,0,0, ,0,10,0,0
1309103605,13,9,103,605,13220,RIVERA,RIVERA,8,8,0,8,8,0,0,0,0,0,8,8,0,0,29,15,14,29,15,14,0,0,0,0,0,0, ,0,10,0,0
1309103606,13,9,103,606,13220,RIVERA,RIVERA,13,13,0,13,13,0,0,0,0,0,13,13,0,0,36,21,15,36,21,15,0,0,0,0,0,0, ,0,10,0,0
1309103607,13,9,103,607,13220,RIVERA,RIVERA,13,12,1,13,12,0,1,0,0,0,12,12,0,0,35,17,18,35,17,18,0,0,0,0,0,0, ,0,10,0,0
1309103608,13,9,103,608,13220,RIVERA,RIVERA,0,0,0,0,0,0,0,0,0,0,0,0,0,0,0,0,0,0,0,0,0,0,0,0,0,0, ,0,10,0,0
1309103609,13,9,103,609,13220,RIVERA,RIVERA,13,12,1,13,12,0,1,0,0,0,12,12,0,0,37,19,18,37,19,18,0,0,0,0,0,0, ,0,10,0,0
1309103610,13,9,103,610,13220,RIVERA,RIVERA,10,10,0,10,10,0,0,0,0,0,10,10,0,0,35,13,22,35,13,22,0,0,0,0,0,0, ,0,10,0,0
1309103611,13,9,103,611,13220,RIVERA,RIVERA,0,0,0,0,0,0,0,0,0,0,0,0,0,0,0,0,0,0,0,0,0,0,0,0,0,0, ,0,10,0,0
1309103612,13,9,103,612,13220,RIVERA,RIVERA,2,2,0,2,2,0,0,0,0,0,2,2,0,0,5,1,4,5,1,4,0,0,0,0,0,0, ,0,10,0,0
1309103613,13,9,103,613,13220,RIVERA,RIVERA,16,13,3,16,13,0,3,0,0,0,13,13,0,0,45,21,24,45,21,24,0,0,0,0,0,0, ,0,10,0,0
1309103614,13,9,103,614,13220,RIVERA,RIVERA,12,11,1,12,11,0,1,0,0,0,11,11,0,0,29,15,14,29,15,14,0,0,0,0,0,0, ,0,10,0,0
1309103615,13,9,103,615,13220,RIVERA,RIVERA,12,12,0,12,12,0,0,0,0,0,12,12,0,0,37,21,16,37,21,16,0,0,0,0,0,0, ,0,10,0,0
1309103616,13,9,103,616,13220,RIVERA,RIVERA,0,0,0,0,0,0,0,0,0,0,0,0,0,0,0,0,0,0,0,0,0,0,0,0,0,0, ,0,10,0,0
1309103617,13,9,103,617,13220,RIVERA,RIVERA,10,10,0,10,10,0,0,0,0,0,10,10,0,0,18,10,8,18,10,8,0,0,0,0,0,0, ,0,10,0,0
1309103618,13,9,103,618,13220,RIVERA,RIVERA,0,0,0,0,0,0,0,0,0,0,0,0,0,0,0,0,0,0,0,0,0,0,0,0,0,0, ,0,10,0,0
1309103619,13,9,103,619,13220,RIVERA,RIVERA,10,9,1,10,9,0,1,0,0,0,9,9,0,0,21,10,11,21,10,11,0,0,0,0,0,0, ,0,10,0,0
1309103620,13,9,103,620,13220,RIVERA,RIVERA,3,3,0,3,3,0,0,0,0,0,3,3,0,0,8,5,3,8,5,3,0,0,0,0,0,0, ,0,10,0,0
1309103621,13,9,103,621,13220,RIVERA,RIVERA,6,6,0,6,6,0,0,0,0,0,6,6,0,0,23,14,9,23,14,9,0,0,0,0,0,0, ,0,10,0,0
1309103622,13,9,103,622,13220,RIVERA,RIVERA,0,0,0,0,0,0,0,0,0,0,0,0,0,0,0,0,0,0,0,0,0,0,0,0,0,0, ,0,10,0,0
1309103623,13,9,103,623,13220,RIVERA,RIVERA,10,10,0,10,10,0,0,0,0,0,10,10,0,0,26,11,15,26,11,15,0,0,0,0,0,0, ,0,10,0,0
1309103624,13,9,103,624,13220,RIVERA,RIVERA,10,9,1,10,9,0,1,0,0,0,9,9,0,0,22,10,12,22,10,12,0,0,0,0,0,0, ,0,10,0,0
1309103625,13,9,103,625,13220,RIVERA,RIVERA,6,6,0,6,6,0,0,0,0,0,6,6,0,0,16,8,8,16,8,8,0,0,0,0,0,0, ,0,10,0,0
1309103626,13,9,103,626,13220,RIVERA,RIVERA,6,6,0,6,6,0,0,0,0,0,6,6,0,0,14,6,8,14,6,8,0,0,0,0,0,0, ,0,10,0,0
1309103627,13,9,103,627,13220,RIVERA,RIVERA,4,4,0,4,4,0,0,0,0,0,4,4,0,0,11,6,5,11,6,5,0,0,0,0,0,0, ,0,10,0,0
1309103628,13,9,103,628,13220,RIVERA,RIVERA,0,0,0,0,0,0,0,0,0,0,0,0,0,0,0,0,0,0,0,0,0,0,0,0,0,0, ,0,10,0,0
1309103629,13,9,103,629,13220,RIVERA,RIVERA,0,0,0,0,0,0,0,0,0,0,0,0,0,0,0,0,0,0,0,0,0,0,0,0,0,0, ,0,10,0,0
1309103630,13,9,103,630,13220,RIVERA,RIVERA,9,9,0,9,9,0,0,0,0,0,9,9,0,0,31,13,18,31,13,18,0,0,0,0,0,0, ,0,10,0,0
1309103631,13,9,103,631,13220,RIVERA,RIVERA,6,6,0,6,6,0,0,0,0,0,6,6,0,0,21,9,12,21,9,12,0,0,0,0,0,0, ,0,10,0,0
1309103632,13,9,103,632,13220,RIVERA,RIVERA,12,11,1,12,11,0,1,0,0,0,11,11,0,0,31,17,14,31,17,14,0,0,0,0,0,0, ,0,10,0,0
1309103633,13,9,103,633,13220,RIVERA,RIVERA,3,3,0,3,3,0,0,0,0,0,3,3,0,0,6,3,3,6,3,3,0,0,0,0,0,0, ,0,10,0,0
1309103634,13,9,103,634,13220,RIVERA,RIVERA,30,26,4,29,25,0,4,1,1,0,26,25,0,1,116,56,60,99,51,48,0,0,0,17,5,12, ,0,10,0,0
1309103700,13,9,103,700,13220,RIVERA,RIVERA,10,10,0,10,10,0,0,0,0,0,10,10,0,0,35,17,18,35,17,18,0,0,0,0,0,0, ,0,10,0,0
1309103701,13,9,103,701,13220,RIVERA,RIVERA,8,3,5,8,3,0,5,0,0,0,3,3,0,0,12,8,4,12,8,4,0,0,0,0,0,0, ,0,10,0,0
1309103702,13,9,103,702,13220,RIVERA,RIVERA,0,0,0,0,0,0,0,0,0,0,0,0,0,0,0,0,0,0,0,0,0,0,0,0,0,0, ,0,10,0,0
1309103703,13,9,103,703,13220,RIVERA,RIVERA,6,4,2,6,4,0,2,0,0,0,4,4,0,0,15,9,6,15,9,6,0,0,0,0,0,0, ,0,10,0,0
1309103704,13,9,103,704,13220,RIVERA,RIVERA,5,5,0,5,5,0,0,0,0,0,5,5,0,0,17,8,9,17,8,9,0,0,0,0,0,0, ,0,10,0,0
1309103800,13,9,103,800,13220,RIVERA,RIVERA,22,20,2,22,20,0,2,0,0,0,20,20,0,0,68,30,38,68,30,38,0,0,0,0,0,0, ,0,10,0,0
1309103801,13,9,103,801,13220,RIVERA,RIVERA,12,11,1,12,11,0,1,0,0,0,11,11,0,0,40,18,22,40,18,22,0,0,0,0,0,0, ,0,10,0,0
1309103803,13,9,103,803,13220,RIVERA,RIVERA,2,1,1,2,1,0,1,0,0,0,1,1,0,0,7,3,4,7,3,4,0,0,0,0,0,0, ,0,10,0,0
1309105001,13,9,105,1,13220,RIVERA,RIVERA,1,1,0,1,1,0,0,0,0,0,1,1,0,0,8,3,5,8,3,5,0,0,0,0,0,0, ,0,9,0,0
1309105002,13,9,105,2,13220,RIVERA,RIVERA,48,46,2,48,46,0,2,0,0,0,46,46,0,0,130,68,62,130,68,62,0,0,0,0,0,0, ,0,9,0,0
1309105003,13,9,105,3,13220,RIVERA,RIVERA,60,52,8,60,52,0,8,0,0,0,52,52,0,0,193,96,97,193,96,97,0,0,0,0,0,0, ,0,9,0,0
1309105004,13,9,105,4,13220,RIVERA,RIVERA,0,0,0,0,0,0,0,0,0,0,0,0,0,0,0,0,0,0,0,0,0,0,0,0,0,0, ,0,9,0,0
1309105005,13,9,105,5,13220,RIVERA,RIVERA,19,19,0,19,19,0,0,0,0,0,19,19,0,0,55,29,26,55,29,26,0,0,0,0,0,0, ,0,9,0,0
1309105020,13,9,105,20,13220,RIVERA,RIVERA,3,3,0,3,3,0,0,0,0,0,3,3,0,0,12,4,8,12,4,8,0,0,0,0,0,0, ,0,9,0,0
1309105025,13,9,105,25,13220,RIVERA,RIVERA,20,19,1,20,19,0,1,0,0,0,19,19,0,0,54,27,27,54,27,27,0,0,0,0,0,0, ,0,9,0,0
1309105026,13,9,105,26,13220,RIVERA,RIVERA,24,23,1,24,23,0,1,0,0,0,23,23,0,0,70,30,40,70,30,40,0,0,0,0,0,0, ,0,9,0,0
1309105027,13,9,105,27,13220,RIVERA,RIVERA,22,20,2,22,20,0,2,0,0,0,21,21,0,0,73,39,34,73,39,34,0,0,0,0,0,0, ,0,9,0,0
1309105028,13,9,105,28,13220,RIVERA,RIVERA,20,18,2,20,18,0,2,0,0,0,18,18,0,0,53,27,26,53,27,26,0,0,0,0,0,0, ,0,9,0,0
1309105029,13,9,105,29,13220,RIVERA,RIVERA,1,1,0,1,1,0,0,0,0,0,1,1,0,0,3,2,1,3,2,1,0,0,0,0,0,0, ,0,9,0,0
1309105030,13,9,105,30,13220,RIVERA,RIVERA,19,15,4,18,14,0,4,1,1,0,15,14,0,1,106,34,72,46,19,27,0,0,0,60,15,45, ,0,9,0,0
1309105035,13,9,105,35,13220,RIVERA,RIVERA,0,0,0,0,0,0,0,0,0,0,0,0,0,0,0,0,0,0,0,0,0,0,0,0,0,0, ,0,9,0,0
1309105036,13,9,105,36,13220,RIVERA,RIVERA,8,8,0,8,8,0,0,0,0,0,8,8,0,0,25,15,10,25,15,10,0,0,0,0,0,0, ,0,9,0,0
1309105037,13,9,105,37,13220,RIVERA,RIVERA,20,17,3,20,17,0,3,0,0,0,17,17,0,0,45,20,25,45,20,25,0,0,0,0,0,0, ,0,9,0,0
1309105402,13,9,105,402,13220,RIVERA,RIVERA,0,0,0,0,0,0,0,0,0,0,0,0,0,0,0,0,0,0,0,0,0,0,0,0,0,0, ,0,9,0,0
1309105403,13,9,105,403,13220,RIVERA,RIVERA,0,0,0,0,0,0,0,0,0,0,0,0,0,0,0,0,0,0,0,0,0,0,0,0,0,0, ,0,9,0,0
1309105404,13,9,105,404,13220,RIVERA,RIVERA,0,0,0,0,0,0,0,0,0,0,0,0,0,0,0,0,0,0,0,0,0,0,0,0,0,0, ,0,9,0,0
1309105405,13,9,105,405,13220,RIVERA,RIVERA,0,0,0,0,0,0,0,0,0,0,0,0,0,0,0,0,0,0,0,0,0,0,0,0,0,0, ,0,9,0,0
1309105406,13,9,105,406,13220,RIVERA,RIVERA,0,0,0,0,0,0,0,0,0,0,0,0,0,0,0,0,0,0,0,0,0,0,0,0,0,0, ,0,9,0,0
1309105407,13,9,105,407,13220,RIVERA,RIVERA,0,0,0,0,0,0,0,0,0,0,0,0,0,0,0,0,0,0,0,0,0,0,0,0,0,0, ,0,9,0,0
1309105408,13,9,105,408,13220,RIVERA,RIVERA,0,0,0,0,0,0,0,0,0,0,0,0,0,0,0,0,0,0,0,0,0,0,0,0,0,0, ,0,9,0,0
1309105409,13,9,105,409,13220,RIVERA,RIVERA,0,0,0,0,0,0,0,0,0,0,0,0,0,0,0,0,0,0,0,0,0,0,0,0,0,0, ,0,9,0,0
1309105600,13,9,105,600,13220,RIVERA,RIVERA,27,26,1,27,26,0,1,0,0,0,26,26,0,0,90,46,44,90,46,44,0,0,0,0,0,0, ,0,9,0,0
1309105601,13,9,105,601,13220,RIVERA,RIVERA,0,0,0,0,0,0,0,0,0,0,0,0,0,0,0,0,0,0,0,0,0,0,0,0,0,0, ,0,9,0,0
1309106002,13,9,106,2,13220,RIVERA,RIVERA,1,1,0,1,1,0,0,0,0,0,1,1,0,0,4,2,2,4,2,2,0,0,0,0,0,0, ,0,9,0,0
1309106013,13,9,106,13,13220,RIVERA,RIVERA,38,38,0,38,38,0,0,0,0,0,40,40,0,0,129,64,65,129,64,65,0,0,0,0,0,0, ,0,9,0,0
1309106016,13,9,106,16,13220,RIVERA,RIVERA,26,26,0,26,26,0,0,0,0,0,26,26,0,0,77,39,38,77,39,38,0,0,0,0,0,0, ,0,9,0,0
1309106019,13,9,106,19,13220,RIVERA,RIVERA,0,0,0,0,0,0,0,0,0,0,0,0,0,0,0,0,0,0,0,0,0,0,0,0,0,0, ,0,9,0,0
1309106022,13,9,106,22,13220,RIVERA,RIVERA,34,33,1,34,33,0,1,0,0,0,33,33,0,0,114,58,56,114,58,56,0,0,0,0,0,0, ,0,9,0,0
1309106023,13,9,106,23,13220,RIVERA,RIVERA,22,22,0,22,22,0,0,0,0,0,22,22,0,0,73,35,38,73,35,38,0,0,0,0,0,0, ,0,9,0,0
1309106024,13,9,106,24,13220,RIVERA,RIVERA,24,24,0,24,24,0,0,0,0,0,27,27,0,0,97,47,50,97,47,50,0,0,0,0,0,0, ,0,9,0,0
1309106025,13,9,106,25,13220,RIVERA,RIVERA,76,76,0,76,76,0,0,0,0,0,78,78,0,0,284,145,139,284,145,139,0,0,0,0,0,0, ,0,9,0,0
1309106027,13,9,106,27,13220,RIVERA,RIVERA,12,12,0,12,12,0,0,0,0,0,12,12,0,0,42,20,22,42,20,22,0,0,0,0,0,0, ,0,9,0,0
1309106029,13,9,106,29,13220,RIVERA,RIVERA,12,11,1,12,11,0,1,0,0,0,11,11,0,0,32,17,15,32,17,15,0,0,0,0,0,0, ,0,9,0,0
1309106030,13,9,106,30,13220,RIVERA,RIVERA,7,6,1,7,6,0,1,0,0,0,8,8,0,0,24,8,16,24,8,16,0,0,0,0,0,0, ,0,9,0,0
1309106031,13,9,106,31,13220,RIVERA,RIVERA,1,1,0,1,1,0,0,0,0,0,1,1,0,0,4,1,3,4,1,3,0,0,0,0,0,0, ,0,9,0,0
1309106032,13,9,106,32,13220,RIVERA,RIVERA,2,2,0,2,2,0,0,0,0,0,2,2,0,0,6,3,3,6,3,3,0,0,0,0,0,0, ,0,9,0,0
1309106033,13,9,106,33,13220,RIVERA,RIVERA,14,10,4,13,10,0,3,1,0,1,10,10,0,0,31,14,17,31,14,17,0,0,0,0,0,0, ,0,9,0,0
1309106034,13,9,106,34,13220,RIVERA,RIVERA,12,12,0,12,12,0,0,0,0,0,12,12,0,0,35,17,18,35,17,18,0,0,0,0,0,0, ,0,9,0,0
1309106035,13,9,106,35,13220,RIVERA,RIVERA,9,9,0,9,9,0,0,0,0,0,9,9,0,0,27,15,12,27,15,12,0,0,0,0,0,0, ,0,9,0,0
1309106036,13,9,106,36,13220,RIVERA,RIVERA,10,10,0,10,10,0,0,0,0,0,10,10,0,0,32,16,16,32,16,16,0,0,0,0,0,0, ,0,9,0,0
1309106037,13,9,106,37,13220,RIVERA,RIVERA,13,12,1,13,12,0,1,0,0,0,12,12,0,0,45,23,22,45,23,22,0,0,0,0,0,0, ,0,9,0,0
1309106038,13,9,106,38,13220,RIVERA,RIVERA,20,16,4,20,16,0,4,0,0,0,16,16,0,0,47,25,22,47,25,22,0,0,0,0,0,0, ,0,9,0,0
1309106042,13,9,106,42,13220,RIVERA,RIVERA,0,0,0,0,0,0,0,0,0,0,0,0,0,0,0,0,0,0,0,0,0,0,0,0,0,0, ,0,9,0,0
1309106400,13,9,106,400,13220,RIVERA,RIVERA,0,0,0,0,0,0,0,0,0,0,0,0,0,0,0,0,0,0,0,0,0,0,0,0,0,0, ,0,9,0,0
1309106501,13,9,106,501,13220,RIVERA,RIVERA,0,0,0,0,0,0,0,0,0,0,0,0,0,0,0,0,0,0,0,0,0,0,0,0,0,0, ,0,9,0,0
1309106502,13,9,106,502,13220,RIVERA,RIVERA,0,0,0,0,0,0,0,0,0,0,0,0,0,0,0,0,0,0,0,0,0,0,0,0,0,0, ,0,9,0,0
1309106600,13,9,106,600,13220,RIVERA,RIVERA,55,50,5,55,50,0,5,0,0,0,50,50,0,0,182,96,86,182,96,86,0,0,0,0,0,0, ,0,9,0,0
1309106601,13,9,106,601,13220,RIVERA,RIVERA,3,3,0,3,3,0,0,0,0,0,3,3,0,0,7,2,5,7,2,5,0,0,0,0,0,0, ,0,9,0,0
1309106602,13,9,106,602,13220,RIVERA,RIVERA,3,2,1,3,2,0,1,0,0,0,2,2,0,0,3,2,1,3,2,1,0,0,0,0,0,0, ,0,9,0,0
1309106603,13,9,106,603,13220,RIVERA,RIVERA,25,25,0,25,25,0,0,0,0,0,28,28,0,0,112,57,55,112,57,55,0,0,0,0,0,0, ,0,9,0,0
1309106604,13,9,106,604,13220,RIVERA,RIVERA,0,0,0,0,0,0,0,0,0,0,0,0,0,0,0,0,0,0,0,0,0,0,0,0,0,0, ,0,9,0,0
1309106605,13,9,106,605,13220,RIVERA,RIVERA,1,1,0,1,1,0,0,0,0,0,1,1,0,0,12,6,6,12,6,6,0,0,0,0,0,0, ,0,9,0,0
1309106606,13,9,106,606,13220,RIVERA,RIVERA,2,2,0,2,2,0,0,0,0,0,2,2,0,0,7,4,3,7,4,3,0,0,0,0,0,0, ,0,9,0,0
1309106607,13,9,106,607,13220,RIVERA,RIVERA,30,29,1,30,29,0,1,0,0,0,29,29,0,0,77,36,41,77,36,41,0,0,0,0,0,0, ,0,9,0,0
1309106608,13,9,106,608,13220,RIVERA,RIVERA,10,9,1,10,9,0,1,0,0,0,11,11,0,0,31,15,16,31,15,16,0,0,0,0,0,0, ,0,9,0,0
1309106609,13,9,106,609,13220,RIVERA,RIVERA,10,10,0,10,10,0,0,0,0,0,10,10,0,0,45,24,21,45,24,21,0,0,0,0,0,0, ,0,9,0,0
1309106610,13,9,106,610,13220,RIVERA,RIVERA,13,11,2,13,11,0,2,0,0,0,11,11,0,0,34,15,19,34,15,19,0,0,0,0,0,0, ,0,9,0,0
1309106611,13,9,106,611,13220,RIVERA,RIVERA,19,19,0,19,19,0,0,0,0,0,19,19,0,0,59,28,31,59,28,31,0,0,0,0,0,0, ,0,9,0,0
1309106612,13,9,106,612,13220,RIVERA,RIVERA,11,9,2,11,9,0,2,0,0,0,9,9,0,0,30,14,16,30,14,16,0,0,0,0,0,0, ,0,9,0,0
1309106613,13,9,106,613,13220,RIVERA,RIVERA,1,1,0,1,1,0,0,0,0,0,1,1,0,0,2,1,1,2,1,1,0,0,0,0,0,0, ,0,9,0,0
1309106614,13,9,106,614,13220,RIVERA,RIVERA,2,2,0,2,2,0,0,0,0,0,2,2,0,0,11,4,7,11,4,7,0,0,0,0,0,0, ,0,9,0,0
1309106615,13,9,106,615,13220,RIVERA,RIVERA,26,22,4,26,22,0,4,0,0,0,22,22,0,0,85,44,41,85,44,41,0,0,0,0,0,0, ,0,9,0,0
1309106616,13,9,106,616,13220,RIVERA,RIVERA,23,22,1,23,22,0,1,0,0,0,22,22,0,0,71,35,36,71,35,36,0,0,0,0,0,0, ,0,9,0,0
1309106617,13,9,106,617,13220,RIVERA,RIVERA,8,7,1,8,7,0,1,0,0,0,7,7,0,0,21,13,8,21,13,8,0,0,0,0,0,0, ,0,9,0,0
1309106800,13,9,106,800,13220,RIVERA,RIVERA,0,0,0,0,0,0,0,0,0,0,0,0,0,0,0,0,0,0,0,0,0,0,0,0,0,0, ,0,9,0,0
1309107001,13,9,107,1,13220,RIVERA,RIVERA,31,27,4,31,27,0,4,0,0,0,28,28,0,0,94,47,47,94,47,47,0,0,0,0,0,0, ,0,9,0,0
1309107002,13,9,107,2,13220,RIVERA,RIVERA,38,37,1,38,37,0,1,0,0,0,37,37,0,0,113,54,59,113,54,59,0,0,0,0,0,0, ,0,9,0,0
1309107003,13,9,107,3,13220,RIVERA,RIVERA,41,38,3,41,38,0,3,0,0,0,38,38,0,0,143,68,75,143,68,75,0,0,0,0,0,0, ,0,9,0,0
1309107004,13,9,107,4,13220,RIVERA,RIVERA,41,17,24,41,17,0,24,0,0,0,17,17,0,0,70,36,34,70,36,34,0,0,0,0,0,0, ,0,9,0,0
1309107005,13,9,107,5,13220,RIVERA,RIVERA,30,16,14,30,16,0,14,0,0,0,16,16,0,0,52,22,30,52,22,30,0,0,0,0,0,0, ,0,9,0,0
1309107006,13,9,107,6,13220,RIVERA,RIVERA,25,22,3,25,22,0,3,0,0,0,22,22,0,0,67,32,35,67,32,35,0,0,0,0,0,0, ,0,9,0,0
1309107007,13,9,107,7,13220,RIVERA,RIVERA,28,24,4,28,24,0,4,0,0,0,24,24,0,0,60,25,35,60,25,35,0,0,0,0,0,0, ,0,9,0,0
1309107008,13,9,107,8,13220,RIVERA,RIVERA,36,33,3,36,33,0,3,0,0,0,33,33,0,0,100,43,57,100,43,57,0,0,0,0,0,0, ,0,9,0,0
1309107009,13,9,107,9,13220,RIVERA,RIVERA,29,28,1,29,28,0,1,0,0,0,28,28,0,0,90,40,50,90,40,50,0,0,0,0,0,0, ,0,9,0,0
1309107010,13,9,107,10,13220,RIVERA,RIVERA,29,28,1,29,28,0,1,0,0,0,28,28,0,0,78,35,43,78,35,43,0,0,0,0,0,0, ,0,9,0,0
1309107011,13,9,107,11,13220,RIVERA,RIVERA,11,11,0,11,11,0,0,0,0,0,11,11,0,0,24,12,12,24,12,12,0,0,0,0,0,0, ,0,9,0,0
1309107012,13,9,107,12,13220,RIVERA,RIVERA,35,34,1,35,34,0,1,0,0,0,35,35,0,0,99,49,50,99,49,50,0,0,0,0,0,0, ,0,9,0,0
1309107013,13,9,107,13,13220,RIVERA,RIVERA,32,27,5,32,27,0,5,0,0,0,27,27,0,0,70,34,36,70,34,36,0,0,0,0,0,0, ,0,9,0,0
1309107014,13,9,107,14,13220,RIVERA,RIVERA,27,24,3,27,24,0,3,0,0,0,24,24,0,0,66,30,36,66,30,36,0,0,0,0,0,0, ,0,9,0,0
1309107015,13,9,107,15,13220,RIVERA,RIVERA,23,23,0,23,23,0,0,0,0,0,23,23,0,0,70,31,39,70,31,39,0,0,0,0,0,0, ,0,9,0,0
1309107016,13,9,107,16,13220,RIVERA,RIVERA,28,22,6,28,22,0,6,0,0,0,22,22,0,0,69,35,34,69,35,34,0,0,0,0,0,0, ,0,9,0,0
1309107017,13,9,107,17,13220,RIVERA,RIVERA,27,25,2,27,25,0,2,0,0,0,25,25,0,0,72,32,40,72,32,40,0,0,0,0,0,0, ,0,9,0,0
1309107018,13,9,107,18,13220,RIVERA,RIVERA,28,23,5,28,23,0,5,0,0,0,24,24,0,0,81,37,44,81,37,44,0,0,0,0,0,0, ,0,9,0,0
1309107019,13,9,107,19,13220,RIVERA,RIVERA,25,21,4,25,21,0,4,0,0,0,21,21,0,0,61,32,29,61,32,29,0,0,0,0,0,0, ,0,9,0,0
1309107020,13,9,107,20,13220,RIVERA,RIVERA,41,34,7,41,34,0,7,0,0,0,34,34,0,0,87,37,50,87,37,50,0,0,0,0,0,0, ,0,9,0,0
1309107021,13,9,107,21,13220,RIVERA,RIVERA,22,20,2,22,20,0,2,0,0,0,21,21,0,0,61,33,28,61,33,28,0,0,0,0,0,0, ,0,9,0,0
1309108001,13,9,108,1,13220,RIVERA,RIVERA,24,24,0,24,24,0,0,0,0,0,24,24,0,0,54,30,24,54,30,24,0,0,0,0,0,0, ,0,9,0,0
1309108003,13,9,108,3,13220,RIVERA,RIVERA,28,27,1,28,27,0,1,0,0,0,28,28,0,0,79,35,44,79,35,44,0,0,0,0,0,0, ,0,9,0,0
1309108004,13,9,108,4,13220,RIVERA,RIVERA,53,46,7,53,46,0,7,0,0,0,50,50,0,0,141,66,75,141,66,75,0,0,0,0,0,0, ,0,9,0,0
1309108005,13,9,108,5,13220,RIVERA,RIVERA,35,31,4,35,31,0,4,0,0,0,33,33,0,0,99,46,53,99,46,53,0,0,0,0,0,0, ,0,9,0,0
1309108006,13,9,108,6,13220,RIVERA,RIVERA,26,21,5,26,21,0,5,0,0,0,21,21,0,0,45,21,24,45,21,24,0,0,0,0,0,0, ,0,9,0,0
1309108007,13,9,108,7,13220,RIVERA,RIVERA,40,36,4,40,36,0,4,0,0,0,36,36,0,0,103,53,50,103,53,50,0,0,0,0,0,0, ,0,9,0,0
1309108008,13,9,108,8,13220,RIVERA,RIVERA,26,24,2,25,23,0,2,1,1,0,24,23,0,1,120,63,57,63,29,34,0,0,0,57,34,23, ,0,9,0,0
1309108009,13,9,108,9,13220,RIVERA,RIVERA,26,22,4,26,22,0,4,0,0,0,22,22,0,0,59,25,34,59,25,34,0,0,0,0,0,0, ,0,9,0,0
1309108032,13,9,108,32,13220,RIVERA,RIVERA,33,32,1,33,32,0,1,0,0,0,33,33,0,0,118,59,59,118,59,59,0,0,0,0,0,0, ,0,9,0,0
1309108036,13,9,108,36,13220,RIVERA,RIVERA,49,31,18,49,31,0,18,0,0,0,31,31,0,0,87,41,46,87,41,46,0,0,0,0,0,0, ,0,9,0,0
1309108037,13,9,108,37,13220,RIVERA,RIVERA,28,24,4,28,24,0,4,0,0,0,25,25,0,0,70,32,38,70,32,38,0,0,0,0,0,0, ,0,9,0,0
1309108038,13,9,108,38,13220,RIVERA,RIVERA,0,0,0,0,0,0,0,0,0,0,0,0,0,0,0,0,0,0,0,0,0,0,0,0,0,0, ,0,9,0,0
1309108039,13,9,108,39,13220,RIVERA,RIVERA,43,37,6,43,37,0,6,0,0,0,38,38,0,0,136,67,69,136,67,69,0,0,0,0,0,0, ,0,9,0,0
1309108041,13,9,108,41,13220,RIVERA,RIVERA,49,49,0,49,49,0,0,0,0,0,50,50,0,0,162,81,81,162,81,81,0,0,0,0,0,0, ,0,9,0,0
1309108042,13,9,108,42,13220,RIVERA,RIVERA,0,0,0,0,0,0,0,0,0,0,0,0,0,0,0,0,0,0,0,0,0,0,0,0,0,0, ,0,9,0,0
1309108045,13,9,108,45,13220,RIVERA,RIVERA,6,5,1,6,5,0,1,0,0,0,5,5,0,0,17,8,9,17,8,9,0,0,0,0,0,0, ,0,9,0,0
1309108047,13,9,108,47,13220,RIVERA,RIVERA,12,12,0,12,12,0,0,0,0,0,12,12,0,0,42,24,18,42,24,18,0,0,0,0,0,0, ,0,9,0,0
1309108050,13,9,108,50,13220,RIVERA,RIVERA,59,58,1,59,58,0,1,0,0,0,60,60,0,0,199,95,104,199,95,104,0,0,0,0,0,0, ,0,9,0,0
1309108051,13,9,108,51,13220,RIVERA,RIVERA,35,30,5,35,30,0,5,0,0,0,31,31,0,0,110,56,54,110,56,54,0,0,0,0,0,0, ,0,9,0,0
1309108053,13,9,108,53,13220,RIVERA,RIVERA,3,1,2,3,1,0,2,0,0,0,1,1,0,0,1,1,0,1,1,0,0,0,0,0,0,0, ,0,9,0,0
1309108054,13,9,108,54,13220,RIVERA,RIVERA,1,1,0,1,1,0,0,0,0,0,1,1,0,0,1,1,0,1,1,0,0,0,0,0,0,0, ,0,9,0,0
1309108400,13,9,108,400,13220,RIVERA,RIVERA,0,0,0,0,0,0,0,0,0,0,0,0,0,0,0,0,0,0,0,0,0,0,0,0,0,0, ,0,9,0,0
1309108401,13,9,108,401,13220,RIVERA,RIVERA,0,0,0,0,0,0,0,0,0,0,0,0,0,0,0,0,0,0,0,0,0,0,0,0,0,0, ,0,1,0,0
1309108402,13,9,108,402,13220,RIVERA,RIVERA,0,0,0,0,0,0,0,0,0,0,0,0,0,0,0,0,0,0,0,0,0,0,0,0,0,0, ,0,9,0,0
1309108403,13,9,108,403,13220,RIVERA,RIVERA,0,0,0,0,0,0,0,0,0,0,0,0,0,0,0,0,0,0,0,0,0,0,0,0,0,0, ,0,9,0,0
1309108404,13,9,108,404,13220,RIVERA,RIVERA,0,0,0,0,0,0,0,0,0,0,0,0,0,0,0,0,0,0,0,0,0,0,0,0,0,0, ,0,9,0,0
1309108405,13,9,108,405,13220,RIVERA,RIVERA,0,0,0,0,0,0,0,0,0,0,0,0,0,0,0,0,0,0,0,0,0,0,0,0,0,0, ,0,9,0,0
1309108406,13,9,108,406,13220,RIVERA,RIVERA,0,0,0,0,0,0,0,0,0,0,0,0,0,0,0,0,0,0,0,0,0,0,0,0,0,0, ,0,9,0,0
1309108407,13,9,108,407,13220,RIVERA,RIVERA,0,0,0,0,0,0,0,0,0,0,0,0,0,0,0,0,0,0,0,0,0,0,0,0,0,0, ,0,9,0,0
1309108408,13,9,108,408,13220,RIVERA,RIVERA,0,0,0,0,0,0,0,0,0,0,0,0,0,0,0,0,0,0,0,0,0,0,0,0,0,0, ,0,9,0,0
1309108409,13,9,108,409,13220,RIVERA,RIVERA,0,0,0,0,0,0,0,0,0,0,0,0,0,0,0,0,0,0,0,0,0,0,0,0,0,0, ,0,9,0,0
1309108410,13,9,108,410,13220,RIVERA,RIVERA,0,0,0,0,0,0,0,0,0,0,0,0,0,0,0,0,0,0,0,0,0,0,0,0,0,0, ,0,9,0,0
1309108411,13,9,108,411,13220,RIVERA,RIVERA,0,0,0,0,0,0,0,0,0,0,0,0,0,0,0,0,0,0,0,0,0,0,0,0,0,0, ,0,9,0,0
1309108601,13,9,108,601,13220,RIVERA,RIVERA,64,53,11,63,52,0,11,1,1,0,55,54,0,1,160,82,78,149,78,71,0,0,0,11,4,7, ,0,9,0,0
1309108602,13,9,108,602,13220,RIVERA,RIVERA,14,12,2,14,12,0,2,0,0,0,12,12,0,0,42,15,27,42,15,27,0,0,0,0,0,0, ,0,9,0,0
1309108603,13,9,108,603,13220,RIVERA,RIVERA,8,8,0,8,8,0,0,0,0,0,8,8,0,0,20,7,13,20,7,13,0,0,0,0,0,0, ,0,9,0,0
1309108604,13,9,108,604,13220,RIVERA,RIVERA,7,6,1,7,6,0,1,0,0,0,6,6,0,0,22,14,8,22,14,8,0,0,0,0,0,0, ,0,9,0,0
1309108605,13,9,108,605,13220,RIVERA,RIVERA,41,40,1,41,40,0,1,0,0,0,40,40,0,0,131,71,60,131,71,60,0,0,0,0,0,0, ,0,9,0,0
1309108607,13,9,108,607,13220,RIVERA,RIVERA,0,0,0,0,0,0,0,0,0,0,0,0,0,0,0,0,0,0,0,0,0,0,0,0,0,0, ,0,9,0,0
1309108608,13,9,108,608,13220,RIVERA,RIVERA,0,0,0,0,0,0,0,0,0,0,0,0,0,0,0,0,0,0,0,0,0,0,0,0,0,0, ,0,9,0,0
1309108609,13,9,108,609,13220,RIVERA,RIVERA,7,7,0,7,7,0,0,0,0,0,7,7,0,0,32,15,17,32,15,17,0,0,0,0,0,0, ,0,9,0,0
1309108610,13,9,108,610,13220,RIVERA,RIVERA,16,16,0,16,16,0,0,0,0,0,16,16,0,0,52,23,29,52,23,29,0,0,0,0,0,0, ,0,9,0,0
1309108611,13,9,108,611,13220,RIVERA,RIVERA,16,16,0,16,16,0,0,0,0,0,18,18,0,0,46,25,21,46,25,21,0,0,0,0,0,0, ,0,9,0,0
1309108612,13,9,108,612,13220,RIVERA,RIVERA,9,8,1,9,8,0,1,0,0,0,8,8,0,0,22,11,11,22,11,11,0,0,0,0,0,0, ,0,9,0,0
1309108613,13,9,108,613,13220,RIVERA,RIVERA,10,10,0,10,10,0,0,0,0,0,10,10,0,0,25,8,17,25,8,17,0,0,0,0,0,0, ,0,9,0,0
1309108614,13,9,108,614,13220,RIVERA,RIVERA,12,12,0,12,12,0,0,0,0,0,12,12,0,0,40,17,23,40,17,23,0,0,0,0,0,0, ,0,9,0,0
1309108615,13,9,108,615,13220,RIVERA,RIVERA,12,12,0,12,12,0,0,0,0,0,12,12,0,0,36,19,17,36,19,17,0,0,0,0,0,0, ,0,9,0,0
1309108616,13,9,108,616,13220,RIVERA,RIVERA,29,25,4,29,25,0,4,0,0,0,25,25,0,0,83,38,45,83,38,45,0,0,0,0,0,0, ,0,9,0,0
1309108700,13,9,108,700,13220,RIVERA,RIVERA,6,6,0,6,6,0,0,0,0,0,6,6,0,0,27,14,13,27,14,13,0,0,0,0,0,0, ,0,9,0,0
1309108701,13,9,108,701,13220,RIVERA,RIVERA,4,4,0,4,4,0,0,0,0,0,4,4,0,0,16,6,10,16,6,10,0,0,0,0,0,0, ,0,9,0,0
1309108702,13,9,108,702,13220,RIVERA,RIVERA,12,12,0,12,12,0,0,0,0,0,12,12,0,0,44,28,16,44,28,16,0,0,0,0,0,0, ,0,9,0,0
1309108703,13,9,108,703,13220,RIVERA,RIVERA,12,12,0,12,12,0,0,0,0,0,12,12,0,0,47,22,25,47,22,25,0,0,0,0,0,0, ,0,9,0,0
1309108704,13,9,108,704,13220,RIVERA,RIVERA,43,36,7,43,36,0,7,0,0,0,36,36,0,0,121,52,69,121,52,69,0,0,0,0,0,0, ,0,9,0,0
1309108705,13,9,108,705,13220,RIVERA,RIVERA,39,30,9,38,30,0,8,1,0,1,30,30,0,0,111,60,51,111,60,51,0,0,0,0,0,0, ,0,9,0,0
1309108706,13,9,108,706,13220,RIVERA,RIVERA,21,18,3,21,18,0,3,0,0,0,18,18,0,0,59,34,25,59,34,25,0,0,0,0,0,0, ,0,9,0,0
1309108707,13,9,108,707,13220,RIVERA,RIVERA,23,22,1,23,22,0,1,0,0,0,22,22,0,0,86,46,40,86,46,40,0,0,0,0,0,0, ,0,9,0,0
1309108708,13,9,108,708,13220,RIVERA,RIVERA,8,8,0,8,8,0,0,0,0,0,8,8,0,0,23,15,8,23,15,8,0,0,0,0,0,0, ,0,9,0,0
1309108709,13,9,108,709,13220,RIVERA,RIVERA,14,14,0,14,14,0,0,0,0,0,14,14,0,0,71,34,37,71,34,37,0,0,0,0,0,0, ,0,9,0,0
1309108802,13,9,108,802,13220,RIVERA,RIVERA,16,15,1,16,15,0,1,0,0,0,15,15,0,0,42,19,23,42,19,23,0,0,0,0,0,0, ,0,9,0,0
1309108805,13,9,108,805,13220,RIVERA,RIVERA,18,16,2,18,16,0,2,0,0,0,16,16,0,0,63,29,34,63,29,34,0,0,0,0,0,0, ,0,9,0,0
1309108806,13,9,108,806,13220,RIVERA,RIVERA,78,74,4,78,74,0,4,0,0,0,74,74,0,0,238,117,121,238,117,121,0,0,0,0,0,0, ,0,9,0,0
1309108807,13,9,108,807,13220,RIVERA,RIVERA,36,36,0,36,36,0,0,0,0,0,36,36,0,0,120,56,64,120,56,64,0,0,0,0,0,0, ,0,9,0,0
1309108808,13,9,108,808,13220,RIVERA,RIVERA,0,0,0,0,0,0,0,0,0,0,0,0,0,0,0,0,0,0,0,0,0,0,0,0,0,0, ,0,9,0,0
1309108810,13,9,108,810,13220,RIVERA,RIVERA,14,14,0,14,14,0,0,0,0,0,14,14,0,0,57,32,25,57,32,25,0,0,0,0,0,0, ,0,9,0,0
1309108813,13,9,108,813,13220,RIVERA,RIVERA,22,20,2,22,20,0,2,0,0,0,21,21,0,0,65,31,34,65,31,34,0,0,0,0,0,0, ,0,9,0,0
1309108818,13,9,108,818,13220,RIVERA,RIVERA,21,21,0,21,21,0,0,0,0,0,21,21,0,0,81,42,39,81,42,39,0,0,0,0,0,0, ,0,9,0,0
1309202400,13,9,202,400,13836,RIVERA,LA PEDRERA,0,0,0,0,0,0,0,0,0,0,0,0,0,0,0,0,0,0,0,0,0,0,0,0,0,0, ,0,9,0,0
1309202600,13,9,202,600,13836,RIVERA,LA PEDRERA,14,14,0,14,14,0,0,0,0,0,14,14,0,0,36,17,19,36,17,19,0,0,0,0,0,0, ,0,9,0,0
1309202601,13,9,202,601,13836,RIVERA,LA PEDRERA,4,4,0,4,4,0,0,0,0,0,4,4,0,0,14,8,6,14,8,6,0,0,0,0,0,0, ,0,9,0,0
1309202602,13,9,202,602,13836,RIVERA,LA PEDRERA,0,0,0,0,0,0,0,0,0,0,0,0,0,0,0,0,0,0,0,0,0,0,0,0,0,0, ,0,9,0,0
1309202603,13,9,202,603,13836,RIVERA,LA PEDRERA,0,0,0,0,0,0,0,0,0,0,0,0,0,0,0,0,0,0,0,0,0,0,0,0,0,0, ,0,9,0,0
1309202604,13,9,202,604,13836,RIVERA,LA PEDRERA,10,9,1,10,9,0,1,0,0,0,9,9,0,0,25,14,11,25,14,11,0,0,0,0,0,0, ,0,9,0,0
1309202605,13,9,202,605,13836,RIVERA,LA PEDRERA,0,0,0,0,0,0,0,0,0,0,0,0,0,0,0,0,0,0,0,0,0,0,0,0,0,0, ,0,9,0,0
1309202606,13,9,202,606,13836,RIVERA,LA PEDRERA,0,0,0,0,0,0,0,0,0,0,0,0,0,0,0,0,0,0,0,0,0,0,0,0,0,0, ,0,9,0,0
1309203005,13,9,203,5,13220,RIVERA,RIVERA,4,4,0,4,4,0,0,0,0,0,4,4,0,0,13,6,7,13,6,7,0,0,0,0,0,0, ,0,10,0,0
1309203019,13,9,203,19,13220,RIVERA,RIVERA,43,41,2,43,41,0,2,0,0,0,41,41,0,0,107,49,58,107,49,58,0,0,0,0,0,0, ,0,10,0,0
1309203020,13,9,203,20,13220,RIVERA,RIVERA,27,27,0,27,27,0,0,0,0,0,27,27,0,0,85,41,44,85,41,44,0,0,0,0,0,0, ,0,10,0,0
1309203023,13,9,203,23,13220,RIVERA,RIVERA,58,53,5,58,53,0,5,0,0,0,53,53,0,0,162,86,76,162,86,76,0,0,0,0,0,0, ,0,10,0,0
1309203024,13,9,203,24,13220,RIVERA,RIVERA,18,12,6,18,12,0,6,0,0,0,12,12,0,0,45,22,23,45,22,23,0,0,0,0,0,0, ,0,10,0,0
1309203025,13,9,203,25,13220,RIVERA,RIVERA,22,21,1,22,21,0,1,0,0,0,21,21,0,0,71,30,41,71,30,41,0,0,0,0,0,0, ,0,10,0,0
1309203026,13,9,203,26,13220,RIVERA,RIVERA,14,14,0,14,14,0,0,0,0,0,14,14,0,0,44,17,27,44,17,27,0,0,0,0,0,0, ,0,10,0,0
1309203027,13,9,203,27,13220,RIVERA,RIVERA,12,11,1,12,11,0,1,0,0,0,11,11,0,0,41,23,18,41,23,18,0,0,0,0,0,0, ,0,10,0,0
1309203028,13,9,203,28,13220,RIVERA,RIVERA,19,18,1,19,18,0,1,0,0,0,18,18,0,0,68,33,35,68,33,35,0,0,0,0,0,0, ,0,10,0,0
1309203029,13,9,203,29,13220,RIVERA,RIVERA,18,17,1,18,17,0,1,0,0,0,17,17,0,0,62,32,30,62,32,30,0,0,0,0,0,0, ,0,10,0,0
1309203037,13,9,203,37,13220,RIVERA,RIVERA,36,27,9,36,27,0,9,0,0,0,27,27,0,0,92,55,37,92,55,37,0,0,0,0,0,0, ,0,10,0,0
1309203039,13,9,203,39,13220,RIVERA,RIVERA,29,24,5,29,24,0,5,0,0,0,24,24,0,0,70,38,32,70,38,32,0,0,0,0,0,0, ,0,10,0,0
1309203040,13,9,203,40,13220,RIVERA,RIVERA,14,10,4,14,10,0,4,0,0,0,10,10,0,0,30,13,17,30,13,17,0,0,0,0,0,0, ,0,10,0,0
1309203041,13,9,203,41,13220,RIVERA,RIVERA,16,12,4,16,12,0,4,0,0,0,12,12,0,0,43,24,19,43,24,19,0,0,0,0,0,0, ,0,10,0,0
1309203042,13,9,203,42,13220,RIVERA,RIVERA,23,16,7,23,16,0,7,0,0,0,16,16,0,0,54,19,35,54,19,35,0,0,0,0,0,0, ,0,10,0,0
1309203043,13,9,203,43,13220,RIVERA,RIVERA,15,6,9,15,6,0,9,0,0,0,6,6,0,0,20,10,10,20,10,10,0,0,0,0,0,0, ,0,10,0,0
1309203046,13,9,203,46,13220,RIVERA,RIVERA,8,5,3,8,5,0,3,0,0,0,5,5,0,0,23,16,7,23,16,7,0,0,0,0,0,0, ,0,10,0,0
1309203052,13,9,203,52,13220,RIVERA,RIVERA,5,4,1,5,4,0,1,0,0,0,4,4,0,0,17,11,6,17,11,6,0,0,0,0,0,0, ,0,10,0,0
1309203600,13,9,203,600,13220,RIVERA,RIVERA,1,1,0,1,1,0,0,0,0,0,1,1,0,0,5,3,2,5,3,2,0,0,0,0,0,0, ,0,10,0,0
1309203601,13,9,203,601,13220,RIVERA,RIVERA,4,4,0,4,4,0,0,0,0,0,4,4,0,0,16,5,11,16,5,11,0,0,0,0,0,0, ,0,10,0,0
1309203602,13,9,203,602,13220,RIVERA,RIVERA,6,6,0,6,6,0,0,0,0,0,6,6,0,0,25,12,13,25,12,13,0,0,0,0,0,0, ,0,10,0,0
1309203700,13,9,203,700,13220,RIVERA,RIVERA,44,38,6,44,38,0,6,0,0,0,38,38,0,0,124,64,60,124,64,60,0,0,0,0,0,0, ,0,10,0,0
1309203800,13,9,203,800,13220,RIVERA,RIVERA,17,17,0,17,17,0,0,0,0,0,17,17,0,0,59,27,32,59,27,32,0,0,0,0,0,0, ,0,10,0,0
1309203801,13,9,203,801,13220,RIVERA,RIVERA,19,17,2,19,17,0,2,0,0,0,18,18,0,0,69,41,28,69,41,28,0,0,0,0,0,0, ,0,10,0,0
1309203805,13,9,203,805,13220,RIVERA,RIVERA,11,8,3,11,8,0,3,0,0,0,8,8,0,0,27,15,12,27,15,12,0,0,0,0,0,0, ,0,10,0,0
1309205007,13,9,205,7,13220,RIVERA,RIVERA,4,3,1,4,3,0,1,0,0,0,3,3,0,0,12,5,7,12,5,7,0,0,0,0,0,0, ,0,9,0,0
1309205008,13,9,205,8,13220,RIVERA,RIVERA,17,17,0,17,17,0,0,0,0,0,17,17,0,0,54,23,31,54,23,31,0,0,0,0,0,0, ,0,9,0,0
1309205009,13,9,205,9,13220,RIVERA,RIVERA,22,21,1,22,21,0,1,0,0,0,22,22,0,0,46,23,23,46,23,23,0,0,0,0,0,0, ,0,9,0,0
1309205010,13,9,205,10,13220,RIVERA,RIVERA,24,24,0,24,24,0,0,0,0,0,25,25,0,0,57,30,27,57,30,27,0,0,0,0,0,0, ,0,9,0,0
1309205011,13,9,205,11,13220,RIVERA,RIVERA,28,27,1,28,27,0,1,0,0,0,28,28,0,0,85,42,43,85,42,43,0,0,0,0,0,0, ,0,9,0,0
1309205012,13,9,205,12,13220,RIVERA,RIVERA,33,30,3,32,29,0,3,1,1,0,31,30,0,1,80,40,40,79,40,39,0,0,0,1,0,1, ,0,9,0,0
1309205013,13,9,205,13,13220,RIVERA,RIVERA,29,25,4,29,25,0,4,0,0,0,25,25,0,0,65,29,36,65,29,36,0,0,0,0,0,0, ,0,9,0,0
1309205014,13,9,205,14,13220,RIVERA,RIVERA,32,28,4,32,28,0,4,0,0,0,28,28,0,0,81,36,45,81,36,45,0,0,0,0,0,0, ,0,9,0,0
1309205015,13,9,205,15,13220,RIVERA,RIVERA,42,39,3,42,39,0,3,0,0,0,39,39,0,0,115,57,58,115,57,58,0,0,0,0,0,0, ,0,9,0,0
1309205016,13,9,205,16,13220,RIVERA,RIVERA,36,34,2,36,34,0,2,0,0,0,34,34,0,0,108,52,56,108,52,56,0,0,0,0,0,0, ,0,9,0,0
1309205017,13,9,205,17,13220,RIVERA,RIVERA,29,27,2,29,27,0,2,0,0,0,30,30,0,0,80,43,37,80,43,37,0,0,0,0,0,0, ,0,9,0,0
1309205018,13,9,205,18,13220,RIVERA,RIVERA,18,17,1,18,17,0,1,0,0,0,18,18,0,0,39,14,25,39,14,25,0,0,0,0,0,0, ,0,9,0,0
1309205019,13,9,205,19,13220,RIVERA,RIVERA,18,18,0,18,18,0,0,0,0,0,18,18,0,0,57,28,29,57,28,29,0,0,0,0,0,0, ,0,9,0,0
1309205021,13,9,205,21,13220,RIVERA,RIVERA,16,16,0,16,16,0,0,0,0,0,16,16,0,0,51,27,24,51,27,24,0,0,0,0,0,0, ,0,9,0,0
1309205022,13,9,205,22,13220,RIVERA,RIVERA,27,26,1,27,26,0,1,0,0,0,26,26,0,0,83,40,43,83,40,43,0,0,0,0,0,0, ,0,9,0,0
1309205024,13,9,205,24,13220,RIVERA,RIVERA,28,24,4,28,24,0,4,0,0,0,25,25,0,0,73,32,41,73,32,41,0,0,0,0,0,0, ,0,9,0,0
1309205400,13,9,205,400,13220,RIVERA,RIVERA,0,0,0,0,0,0,0,0,0,0,0,0,0,0,0,0,0,0,0,0,0,0,0,0,0,0, ,0,9,0,0
1309205401,13,9,205,401,13220,RIVERA,RIVERA,0,0,0,0,0,0,0,0,0,0,0,0,0,0,0,0,0,0,0,0,0,0,0,0,0,0, ,0,9,0,0
1309205402,13,9,205,402,13220,RIVERA,RIVERA,0,0,0,0,0,0,0,0,0,0,0,0,0,0,0,0,0,0,0,0,0,0,0,0,0,0, ,0,9,0,0
1309205403,13,9,205,403,13220,RIVERA,RIVERA,0,0,0,0,0,0,0,0,0,0,0,0,0,0,0,0,0,0,0,0,0,0,0,0,0,0, ,0,9,0,0
1309205404,13,9,205,404,13220,RIVERA,RIVERA,0,0,0,0,0,0,0,0,0,0,0,0,0,0,0,0,0,0,0,0,0,0,0,0,0,0, ,0,9,0,0
1309205600,13,9,205,600,13220,RIVERA,RIVERA,0,0,0,0,0,0,0,0,0,0,0,0,0,0,0,0,0,0,0,0,0,0,0,0,0,0, ,0,9,0,0
1309205601,13,9,205,601,13220,RIVERA,RIVERA,26,23,3,26,23,0,3,0,0,0,23,23,0,0,62,33,29,62,33,29,0,0,0,0,0,0, ,0,9,0,0
1309206004,13,9,206,4,13220,RIVERA,RIVERA,21,19,2,21,19,0,2,0,0,0,21,21,0,0,56,26,30,56,26,30,0,0,0,0,0,0, ,0,9,0,0
1309206005,13,9,206,5,13220,RIVERA,RIVERA,38,36,2,38,36,0,2,0,0,0,37,37,0,0,114,61,53,114,61,53,0,0,0,0,0,0, ,0,9,0,0
1309206006,13,9,206,6,13220,RIVERA,RIVERA,36,32,4,36,32,0,4,0,0,0,32,32,0,0,84,38,46,84,38,46,0,0,0,0,0,0, ,0,9,0,0
1309206007,13,9,206,7,13220,RIVERA,RIVERA,34,33,1,34,33,0,1,0,0,0,36,36,0,0,109,59,50,109,59,50,0,0,0,0,0,0, ,0,9,0,0
1309206008,13,9,206,8,13220,RIVERA,RIVERA,2,1,1,2,1,0,1,0,0,0,1,1,0,0,3,1,2,3,1,2,0,0,0,0,0,0, ,0,9,0,0
1309206009,13,9,206,9,13220,RIVERA,RIVERA,18,17,1,18,17,0,1,0,0,0,18,18,0,0,59,32,27,59,32,27,0,0,0,0,0,0, ,0,9,0,0
1309206010,13,9,206,10,13220,RIVERA,RIVERA,31,29,2,31,29,0,2,0,0,0,30,30,0,0,103,46,57,103,46,57,0,0,0,0,0,0, ,0,9,0,0
1309206600,13,9,206,600,13220,RIVERA,RIVERA,79,71,8,79,71,0,8,0,0,0,74,74,0,0,237,124,113,237,124,113,0,0,0,0,0,0, ,0,9,0,0
1309206601,13,9,206,601,13220,RIVERA,RIVERA,45,32,13,45,32,0,13,0,0,0,32,32,0,0,108,52,56,108,52,56,0,0,0,0,0,0, ,0,9,0,0
1309206602,13,9,206,602,13220,RIVERA,RIVERA,5,4,1,5,4,0,1,0,0,0,4,4,0,0,13,8,5,13,8,5,0,0,0,0,0,0, ,0,9,0,0
1309207022,13,9,207,22,13220,RIVERA,RIVERA,28,23,5,28,23,0,5,0,0,0,23,23,0,0,70,32,38,70,32,38,0,0,0,0,0,0, ,0,9,0,0
1309207023,13,9,207,23,13220,RIVERA,RIVERA,33,29,4,33,29,1,4,0,0,0,29,29,1,0,87,39,48,87,39,48,3,1,2,0,0,0, ,0,9,0,0
1309207024,13,9,207,24,13220,RIVERA,RIVERA,38,33,5,38,33,0,5,0,0,0,33,33,0,0,110,59,51,110,59,51,0,0,0,0,0,0, ,0,9,0,0
1309207025,13,9,207,25,13220,RIVERA,RIVERA,38,32,6,38,32,0,6,0,0,0,34,34,0,0,92,45,47,92,45,47,0,0,0,0,0,0, ,0,9,0,0
1309207026,13,9,207,26,13220,RIVERA,RIVERA,27,26,1,27,26,0,1,0,0,0,26,26,0,0,67,29,38,67,29,38,0,0,0,0,0,0, ,0,9,0,0
1309207027,13,9,207,27,13220,RIVERA,RIVERA,36,34,2,36,34,0,2,0,0,0,34,34,0,0,100,40,60,100,40,60,0,0,0,0,0,0, ,0,9,0,0
1309207028,13,9,207,28,13220,RIVERA,RIVERA,116,104,12,116,104,0,12,0,0,0,106,106,0,0,328,157,171,328,157,171,0,0,0,0,0,0, ,0,9,0,0
1309207029,13,9,207,29,13220,RIVERA,RIVERA,33,30,3,33,30,0,3,0,0,0,30,30,0,0,87,35,52,87,35,52,0,0,0,0,0,0, ,0,9,0,0
1309207030,13,9,207,30,13220,RIVERA,RIVERA,21,10,11,21,10,0,11,0,0,0,10,10,0,0,30,11,19,30,11,19,0,0,0,0,0,0, ,0,9,0,0
1309207031,13,9,207,31,13220,RIVERA,RIVERA,38,33,5,38,33,0,5,0,0,0,33,33,0,0,78,37,41,78,37,41,0,0,0,0,0,0, ,0,9,0,0
1309207032,13,9,207,32,13220,RIVERA,RIVERA,24,21,3,24,21,0,3,0,0,0,21,21,0,0,73,35,38,73,35,38,0,0,0,0,0,0, ,0,9,0,0
1309207033,13,9,207,33,13220,RIVERA,RIVERA,33,26,7,33,26,0,7,0,0,0,26,26,0,0,83,32,51,83,32,51,0,0,0,0,0,0, ,0,9,0,0
1309207034,13,9,207,34,13220,RIVERA,RIVERA,40,34,6,40,34,0,6,0,0,0,34,34,0,0,102,47,55,102,47,55,0,0,0,0,0,0, ,0,9,0,0
1309207035,13,9,207,35,13220,RIVERA,RIVERA,46,36,10,46,36,0,10,0,0,0,37,37,0,0,111,63,48,111,63,48,0,0,0,0,0,0, ,0,9,0,0
1309207036,13,9,207,36,13220,RIVERA,RIVERA,37,35,2,37,35,0,2,0,0,0,35,35,0,0,108,55,53,108,55,53,0,0,0,0,0,0, ,0,9,0,0
1309207037,13,9,207,37,13220,RIVERA,RIVERA,36,34,2,36,34,0,2,0,0,0,34,34,0,0,106,54,52,106,54,52,0,0,0,0,0,0, ,0,9,0,0
1309207038,13,9,207,38,13220,RIVERA,RIVERA,37,34,3,37,34,0,3,0,0,0,34,34,0,0,96,47,49,96,47,49,0,0,0,0,0,0, ,0,9,0,0
1309207039,13,9,207,39,13220,RIVERA,RIVERA,31,26,5,31,26,0,5,0,0,0,26,26,0,0,80,39,41,80,39,41,0,0,0,0,0,0, ,0,9,0,0
1309208011,13,9,208,11,13220,RIVERA,RIVERA,44,42,2,44,42,0,2,0,0,0,44,44,0,0,129,55,74,129,55,74,0,0,0,0,0,0, ,0,9,0,0
1309208012,13,9,208,12,13220,RIVERA,RIVERA,19,17,2,19,17,0,2,0,0,0,17,17,0,0,51,24,27,51,24,27,0,0,0,0,0,0, ,0,9,0,0
1309208013,13,9,208,13,13220,RIVERA,RIVERA,10,9,1,10,9,0,1,0,0,0,10,10,0,0,28,13,15,28,13,15,0,0,0,0,0,0, ,0,9,0,0
1309208027,13,9,208,27,13220,RIVERA,RIVERA,40,37,3,40,37,0,3,0,0,0,38,38,0,0,127,61,66,127,61,66,0,0,0,0,0,0, ,0,9,0,0
1309208028,13,9,208,28,13220,RIVERA,RIVERA,16,11,5,16,11,0,5,0,0,0,11,11,0,0,26,10,16,26,10,16,0,0,0,0,0,0, ,0,9,0,0
1309208030,13,9,208,30,13220,RIVERA,RIVERA,24,23,1,24,23,0,1,0,0,0,23,23,0,0,75,40,35,75,40,35,0,0,0,0,0,0, ,0,9,0,0
1309208062,13,9,208,62,13220,RIVERA,RIVERA,23,19,4,23,19,0,4,0,0,0,20,20,0,0,75,29,46,75,29,46,0,0,0,0,0,0, ,0,9,0,0
1309208063,13,9,208,63,13220,RIVERA,RIVERA,15,14,1,15,14,0,1,0,0,0,15,15,0,0,41,20,21,41,20,21,0,0,0,0,0,0, ,0,9,0,0
1309208064,13,9,208,64,13220,RIVERA,RIVERA,7,6,1,7,6,0,1,0,0,0,8,8,0,0,22,11,11,22,11,11,0,0,0,0,0,0, ,0,9,0,0
1309208065,13,9,208,65,13220,RIVERA,RIVERA,28,27,1,28,27,0,1,0,0,0,28,28,0,0,98,46,52,98,46,52,0,0,0,0,0,0, ,0,9,0,0
1309208400,13,9,208,400,13220,RIVERA,RIVERA,0,0,0,0,0,0,0,0,0,0,0,0,0,0,0,0,0,0,0,0,0,0,0,0,0,0, ,0,9,0,0
1309208401,13,9,208,401,13220,RIVERA,RIVERA,0,0,0,0,0,0,0,0,0,0,0,0,0,0,0,0,0,0,0,0,0,0,0,0,0,0, ,0,9,0,0
1309208402,13,9,208,402,13220,RIVERA,RIVERA,0,0,0,0,0,0,0,0,0,0,0,0,0,0,0,0,0,0,0,0,0,0,0,0,0,0, ,0,9,0,0
1309208403,13,9,208,403,13220,RIVERA,RIVERA,0,0,0,0,0,0,0,0,0,0,0,0,0,0,0,0,0,0,0,0,0,0,0,0,0,0, ,0,9,0,0
1309208404,13,9,208,404,13220,RIVERA,RIVERA,0,0,0,0,0,0,0,0,0,0,0,0,0,0,0,0,0,0,0,0,0,0,0,0,0,0, ,0,9,0,0
1309208405,13,9,208,405,13220,RIVERA,RIVERA,0,0,0,0,0,0,0,0,0,0,0,0,0,0,0,0,0,0,0,0,0,0,0,0,0,0, ,0,9,0,0
1309208406,13,9,208,406,13220,RIVERA,RIVERA,0,0,0,0,0,0,0,0,0,0,0,0,0,0,0,0,0,0,0,0,0,0,0,0,0,0, ,0,9,0,0
1309208600,13,9,208,600,13220,RIVERA,RIVERA,70,67,3,70,67,0,3,0,0,0,75,75,0,0,292,161,131,292,161,131,0,0,0,0,0,0, ,0,9,0,0
1309208601,13,9,208,601,13220,RIVERA,RIVERA,45,42,3,45,42,0,3,0,0,0,43,43,0,0,145,70,75,145,70,75,0,0,0,0,0,0, ,0,9,0,0
1309208602,13,9,208,602,13220,RIVERA,RIVERA,7,7,0,7,7,0,0,0,0,0,7,7,0,0,24,12,12,24,12,12,0,0,0,0,0,0, ,0,9,0,0
1309208800,13,9,208,800,13220,RIVERA,RIVERA,37,35,2,37,35,0,2,0,0,0,35,35,0,0,97,45,52,97,45,52,0,0,0,0,0,0, ,0,9,0,0
1309208801,13,9,208,801,13220,RIVERA,RIVERA,10,9,1,10,9,0,1,0,0,0,10,10,0,0,24,10,14,24,10,14,0,0,0,0,0,0, ,0,9,0,0
1309208802,13,9,208,802,13220,RIVERA,RIVERA,6,3,3,6,3,0,3,0,0,0,3,3,0,0,8,3,5,8,3,5,0,0,0,0,0,0, ,0,9,0,0
1309208803,13,9,208,803,13220,RIVERA,RIVERA,6,5,1,6,5,0,1,0,0,0,5,5,0,0,18,6,12,18,6,12,0,0,0,0,0,0, ,0,9,0,0
1309301600,13,9,301,600,13220,RIVERA,RIVERA,10,8,2,10,8,0,2,0,0,0,8,8,0,0,24,13,11,24,13,11,0,0,0,0,0,0, ,0,10,0,0
1309301700,13,9,301,700,13220,RIVERA,RIVERA,84,68,16,84,68,0,16,0,0,0,68,68,0,0,228,120,108,228,120,108,0,0,0,0,0,0, ,0,10,0,0
1309301824,13,9,301,824,13220,RIVERA,RIVERA,3,0,3,3,0,0,3,0,0,0,0,0,0,0,0,0,0,0,0,0,0,0,0,0,0,0, ,0,10,0,0
1309301825,13,9,301,825,13220,RIVERA,RIVERA,4,3,1,4,3,0,1,0,0,0,3,3,0,0,9,5,4,9,5,4,0,0,0,0,0,0, ,0,10,0,0
1309301826,13,9,301,826,13220,RIVERA,RIVERA,17,16,1,17,16,0,1,0,0,0,16,16,0,0,55,25,30,55,25,30,0,0,0,0,0,0, ,0,10,0,0
1309301827,13,9,301,827,13220,RIVERA,RIVERA,4,4,0,4,4,0,0,0,0,0,4,4,0,0,14,7,7,14,7,7,0,0,0,0,0,0, ,0,10,0,0
1309301828,13,9,301,828,13220,RIVERA,RIVERA,1,1,0,1,1,0,0,0,0,0,1,1,0,0,2,0,2,2,0,2,0,0,0,0,0,0, ,0,10,0,0
1309301829,13,9,301,829,13220,RIVERA,RIVERA,2,1,1,2,1,0,1,0,0,0,1,1,0,0,3,1,2,3,1,2,0,0,0,0,0,0, ,0,10,0,0
1309301877,13,9,301,877,13220,RIVERA,RIVERA,4,0,4,4,0,0,4,0,0,0,0,0,0,0,0,0,0,0,0,0,0,0,0,0,0,0, ,0,10,0,0
1309301878,13,9,301,878,13220,RIVERA,RIVERA,3,3,0,3,3,0,0,0,0,0,3,3,0,0,12,7,5,12,7,5,0,0,0,0,0,0, ,0,10,0,0
1309308015,13,9,308,15,13220,RIVERA,RIVERA,0,0,0,0,0,0,0,0,0,0,0,0,0,0,0,0,0,0,0,0,0,0,0,0,0,0, ,0,9,0,0
1309308016,13,9,308,16,13220,RIVERA,RIVERA,25,25,0,25,25,0,0,0,0,0,25,25,0,0,83,42,41,83,42,41,0,0,0,0,0,0, ,0,9,0,0
1309308017,13,9,308,17,13220,RIVERA,RIVERA,22,19,3,22,19,0,3,0,0,0,19,19,0,0,59,26,33,59,26,33,0,0,0,0,0,0, ,0,9,0,0
1309308018,13,9,308,18,13220,RIVERA,RIVERA,22,19,3,22,19,0,3,0,0,0,20,20,0,0,59,25,34,59,25,34,0,0,0,0,0,0, ,0,9,0,0
1309308021,13,9,308,21,13220,RIVERA,RIVERA,49,47,2,49,47,0,2,0,0,0,48,48,0,0,174,83,91,174,83,91,0,0,0,0,0,0, ,0,9,0,0
1309308022,13,9,308,22,13220,RIVERA,RIVERA,20,17,3,20,17,0,3,0,0,0,17,17,0,0,58,33,25,58,33,25,0,0,0,0,0,0, ,0,9,0,0
1309308067,13,9,308,67,13220,RIVERA,RIVERA,19,16,3,19,16,0,3,0,0,0,16,16,0,0,51,27,24,51,27,24,0,0,0,0,0,0, ,0,9,0,0
1309308068,13,9,308,68,13220,RIVERA,RIVERA,5,4,1,5,4,0,1,0,0,0,4,4,0,0,14,5,9,14,5,9,0,0,0,0,0,0, ,0,9,0,0
1309308069,13,9,308,69,13220,RIVERA,RIVERA,28,28,0,28,28,0,0,0,0,0,28,28,0,0,92,48,44,92,48,44,0,0,0,0,0,0, ,0,9,0,0
1309308072,13,9,308,72,13220,RIVERA,RIVERA,15,14,1,15,14,0,1,0,0,0,14,14,0,0,46,22,24,46,22,24,0,0,0,0,0,0, ,0,9,0,0
1309308073,13,9,308,73,13220,RIVERA,RIVERA,41,38,3,41,38,0,3,0,0,0,40,40,0,0,118,56,62,118,56,62,0,0,0,0,0,0, ,0,9,0,0
1309308074,13,9,308,74,13220,RIVERA,RIVERA,37,30,7,37,30,0,7,0,0,0,31,31,0,0,111,54,57,111,54,57,0,0,0,0,0,0, ,0,9,0,0
1309308075,13,9,308,75,13220,RIVERA,RIVERA,16,16,0,16,16,0,0,0,0,0,16,16,0,0,58,29,29,58,29,29,0,0,0,0,0,0, ,0,9,0,0
1309308076,13,9,308,76,13220,RIVERA,RIVERA,10,10,0,10,10,0,0,0,0,0,10,10,0,0,28,13,15,28,13,15,0,0,0,0,0,0, ,0,9,0,0
1309308077,13,9,308,77,13220,RIVERA,RIVERA,10,10,0,10,10,0,0,0,0,0,10,10,0,0,21,11,10,21,11,10,0,0,0,0,0,0, ,0,9,0,0
1309308078,13,9,308,78,13220,RIVERA,RIVERA,57,53,4,57,53,0,4,0,0,0,54,54,0,0,179,86,93,179,86,93,0,0,0,0,0,0, ,0,9,0,0
1309308400,13,9,308,400,13220,RIVERA,RIVERA,0,0,0,0,0,0,0,0,0,0,0,0,0,0,0,0,0,0,0,0,0,0,0,0,0,0, ,0,9,0,0
1309308600,13,9,308,600,13220,RIVERA,RIVERA,1,1,0,1,1,0,0,0,0,0,1,1,0,0,3,1,2,3,1,2,0,0,0,0,0,0, ,0,9,0,0
1309308601,13,9,308,601,13220,RIVERA,RIVERA,3,3,0,3,3,0,0,0,0,0,3,3,0,0,11,6,5,11,6,5,0,0,0,0,0,0, ,0,9,0,0
1309308602,13,9,308,602,13220,RIVERA,RIVERA,5,5,0,5,5,0,0,0,0,0,5,5,0,0,18,11,7,18,11,7,0,0,0,0,0,0, ,0,9,0,0
1309308603,13,9,308,603,13220,RIVERA,RIVERA,11,10,1,11,10,0,1,0,0,0,10,10,0,0,32,16,16,32,16,16,0,0,0,0,0,0, ,0,9,0,0
1309308604,13,9,308,604,13220,RIVERA,RIVERA,20,19,1,20,19,0,1,0,0,0,20,20,0,0,71,34,37,71,34,37,0,0,0,0,0,0, ,0,9,0,0
1309308605,13,9,308,605,13220,RIVERA,RIVERA,3,2,1,3,2,0,1,0,0,0,2,2,0,0,5,2,3,5,2,3,0,0,0,0,0,0, ,0,9,0,0
1309308800,13,9,308,800,13220,RIVERA,RIVERA,43,40,3,43,40,0,3,0,0,0,40,40,0,0,122,58,64,122,58,64,0,0,0,0,0,0, ,0,9,0,0
1309401600,13,9,401,600,13220,RIVERA,RIVERA,43,38,5,43,38,0,5,0,0,0,40,40,0,0,121,68,53,121,68,53,0,0,0,0,0,0, ,0,9,0,0
1309401601,13,9,401,601,13220,RIVERA,RIVERA,14,13,1,14,13,0,1,0,0,0,13,13,0,0,51,27,24,51,27,24,0,0,0,0,0,0, ,0,9,0,0
1309401853,13,9,401,853,13220,RIVERA,RIVERA,23,22,1,23,22,0,1,0,0,0,22,22,0,0,79,43,36,79,43,36,0,0,0,0,0,0, ,0,9,0,0
1309401854,13,9,401,854,13220,RIVERA,RIVERA,23,20,3,23,20,0,3,0,0,0,20,20,0,0,77,29,48,77,29,48,0,0,0,0,0,0, ,0,9,0,0
1309401855,13,9,401,855,13220,RIVERA,RIVERA,6,6,0,6,6,0,0,0,0,0,6,6,0,0,25,10,15,25,10,15,0,0,0,0,0,0, ,0,9,0,0
1309401861,13,9,401,861,13220,RIVERA,RIVERA,20,18,2,20,18,0,2,0,0,0,18,18,0,0,75,39,36,75,39,36,0,0,0,0,0,0, ,0,9,0,0
1309401862,13,9,401,862,13220,RIVERA,RIVERA,15,15,0,15,15,0,0,0,0,0,15,15,0,0,50,27,23,50,27,23,0,0,0,0,0,0, ,0,9,0,0
1309401863,13,9,401,863,13220,RIVERA,RIVERA,10,10,0,10,10,0,0,0,0,0,10,10,0,0,40,16,24,40,16,24,0,0,0,0,0,0, ,0,9,0,0
1309401865,13,9,401,865,13220,RIVERA,RIVERA,5,5,0,5,5,0,0,0,0,0,5,5,0,0,20,9,11,20,9,11,0,0,0,0,0,0, ,0,9,0,0
1309401879,13,9,401,879,13220,RIVERA,RIVERA,9,9,0,9,9,0,0,0,0,0,10,10,0,0,27,11,16,27,11,16,0,0,0,0,0,0, ,0,9,0,0
1309501600,13,9,501,600,13220,RIVERA,RIVERA,8,5,3,8,5,0,3,0,0,0,5,5,0,0,12,5,7,12,5,7,0,0,0,0,0,0, ,0,10,0,0
1309501601,13,9,501,601,13220,RIVERA,RIVERA,7,7,0,7,7,0,0,0,0,0,8,8,0,0,21,10,11,21,10,11,0,0,0,0,0,0, ,0,10,0,0
1309501832,13,9,501,832,13220,RIVERA,RIVERA,9,9,0,9,9,0,0,0,0,0,9,9,0,0,36,19,17,36,19,17,0,0,0,0,0,0, ,0,10,0,0
1309501833,13,9,501,833,13220,RIVERA,RIVERA,5,4,1,5,4,0,1,0,0,0,4,4,0,0,17,10,7,17,10,7,0,0,0,0,0,0, ,0,10,0,0
1309501834,13,9,501,834,13220,RIVERA,RIVERA,2,1,1,2,1,0,1,0,0,0,1,1,0,0,1,1,0,1,1,0,0,0,0,0,0,0, ,0,10,0,0
1309501835,13,9,501,835,13220,RIVERA,RIVERA,12,8,4,12,8,0,4,0,0,0,8,8,0,0,25,13,12,25,13,12,0,0,0,0,0,0, ,0,10,0,0
1309501836,13,9,501,836,13220,RIVERA,RIVERA,18,13,5,18,13,0,5,0,0,0,13,13,0,0,41,20,21,41,20,21,0,0,0,0,0,0, ,0,10,0,0
1309501837,13,9,501,837,13220,RIVERA,RIVERA,17,13,4,17,13,0,4,0,0,0,15,15,0,0,41,22,19,41,22,19,0,0,0,0,0,0, ,0,10,0,0
1309501838,13,9,501,838,13220,RIVERA,RIVERA,7,6,1,7,6,0,1,0,0,0,6,6,0,0,20,8,12,20,8,12,0,0,0,0,0,0, ,0,10,0,0
1309501839,13,9,501,839,13220,RIVERA,RIVERA,2,2,0,2,2,0,0,0,0,0,2,2,0,0,10,5,5,10,5,5,0,0,0,0,0,0, ,0,10,0,0
1309501840,13,9,501,840,13220,RIVERA,RIVERA,4,4,0,4,4,0,0,0,0,0,4,4,0,0,20,11,9,20,11,9,0,0,0,0,0,0, ,0,10,0,0
1309501841,13,9,501,841,13220,RIVERA,RIVERA,11,8,3,11,8,0,3,0,0,0,8,8,0,0,26,14,12,26,14,12,0,0,0,0,0,0, ,0,10,0,0
1309501842,13,9,501,842,13220,RIVERA,RIVERA,3,2,1,3,2,0,1,0,0,0,2,2,0,0,15,6,9,15,6,9,0,0,0,0,0,0, ,0,10,0,0
1309501843,13,9,501,843,13220,RIVERA,RIVERA,2,2,0,2,2,0,0,0,0,0,2,2,0,0,10,7,3,10,7,3,0,0,0,0,0,0, ,0,10,0,0
1309501844,13,9,501,844,13220,RIVERA,RIVERA,3,3,0,3,3,0,0,0,0,0,3,3,0,0,9,4,5,9,4,5,0,0,0,0,0,0, ,0,10,0,0
1309501845,13,9,501,845,13220,RIVERA,RIVERA,0,0,0,0,0,0,0,0,0,0,0,0,0,0,0,0,0,0,0,0,0,0,0,0,0,0, ,0,10,0,0
1309501846,13,9,501,846,13220,RIVERA,RIVERA,3,3,0,3,3,0,0,0,0,0,3,3,0,0,8,4,4,8,4,4,0,0,0,0,0,0, ,0,10,0,0
1309501847,13,9,501,847,13220,RIVERA,RIVERA,2,2,0,2,2,0,0,0,0,0,2,2,0,0,6,3,3,6,3,3,0,0,0,0,0,0, ,0,10,0,0
1309501848,13,9,501,848,13220,RIVERA,RIVERA,1,1,0,1,1,0,0,0,0,0,1,1,0,0,2,2,0,2,2,0,0,0,0,0,0,0, ,0,10,0,0
1309501849,13,9,501,849,13220,RIVERA,RIVERA,0,0,0,0,0,0,0,0,0,0,0,0,0,0,0,0,0,0,0,0,0,0,0,0,0,0, ,0,10,0,0
1309501850,13,9,501,850,13220,RIVERA,RIVERA,6,5,1,6,5,0,1,0,0,0,5,5,0,0,20,8,12,20,8,12,0,0,0,0,0,0, ,0,10,0,0
1309601600,13,9,601,600,13721,RIVERA,SANTA TERESA,41,26,15,41,26,0,15,0,0,0,26,26,0,0,96,46,50,96,46,50,0,0,0,0,0,0, ,0,10,0,0
1309601601,13,9,601,601,13721,RIVERA,SANTA TERESA,6,3,3,6,3,0,3,0,0,0,3,3,0,0,9,4,5,9,4,5,0,0,0,0,0,0, ,0,10,0,0
1309601602,13,9,601,602,13721,RIVERA,SANTA TERESA,34,21,13,34,21,0,13,0,0,0,21,21,0,0,64,37,27,64,37,27,0,0,0,0,0,0, ,0,10,0,0
1309701600,13,9,701,600,13721,RIVERA,SANTA TERESA,30,30,0,30,30,0,0,0,0,0,30,30,0,0,98,47,51,98,47,51,0,0,0,0,0,0, ,0,9,0,0
1309701601,13,9,701,601,13721,RIVERA,SANTA TERESA,67,35,32,67,35,0,32,0,0,0,35,35,0,0,136,72,64,136,72,64,0,0,0,0,0,0, ,0,9,0,0
1309701602,13,9,701,602,13721,RIVERA,SANTA TERESA,0,0,0,0,0,0,0,0,0,0,0,0,0,0,0,0,0,0,0,0,0,0,0,0,0,0, ,0,9,0,0
1309701603,13,9,701,603,13721,RIVERA,SANTA TERESA,63,32,31,63,32,0,31,0,0,0,32,32,0,0,117,67,50,117,67,50,0,0,0,0,0,0, ,0,9,0,0
1309801600,13,9,801,600,13837,RIVERA,MANDUBI,3,3,0,3,3,0,0,0,0,0,3,3,0,0,14,9,5,14,9,5,0,0,0,0,0,0, ,0,9,0,0
1309801601,13,9,801,601,13837,RIVERA,MANDUBI,2,1,1,2,1,0,1,0,0,0,1,1,0,0,4,2,2,4,2,2,0,0,0,0,0,0, ,0,9,0,0
1309801858,13,9,801,858,13837,RIVERA,MANDUBI,9,7,2,9,7,0,2,0,0,0,7,7,0,0,24,13,11,24,13,11,0,0,0,0,0,0, ,0,9,0,0
1309901600,13,9,901,600,13220,RIVERA,RIVERA,0,0,0,0,0,0,0,0,0,0,0,0,0,0,0,0,0,0,0,0,0,0,0,0,0,0, ,0,10,0,0
1309901601,13,9,901,601,13220,RIVERA,RIVERA,8,6,2,8,6,0,2,0,0,0,6,6,0,0,22,12,10,22,12,10,0,0,0,0,0,0, ,0,10,0,0
1309901602,13,9,901,602,13220,RIVERA,RIVERA,3,1,2,3,1,0,2,0,0,0,1,1,0,0,8,2,6,8,2,6,0,0,0,0,0,0, ,0,10,0,0
1309901603,13,9,901,603,13220,RIVERA,RIVERA,5,4,1,5,4,0,1,0,0,0,4,4,0,0,11,5,6,11,5,6,0,0,0,0,0,0, ,0,10,0,0
